border_size=1
usage=map

Xu          , Xu          , Qxu         , Xu          , Uh          , Xu          , Xu          , Xu          , Qxu         , Xu          , Qxu         , Xu          , Ql          , Xu          , Ql          , Xu          , Xu          , Xu          , Xu          , Xu          , Xu          , Ql          , Ql          , Ql          , Ql          , Xu          , Uu          , Ql          , Ql          , Ql          , Cud         , Ql          , Cud         , Ql          , Cud         , Ql          , Cud         , Ql          , Cud         , Ql          , Ql          , Ql          
Xu          , Xu          , Qxu         , Xu          , Uh          , Xu          , Xu          , Xu          , Qxu         , Xu          , Qxu         , Xu          , Ql          , Xu          , Ql          , Xu          , Xu          , Xu          , Xu          , Xu          , Xu          , Ql          , Ql          , Ql          , Ql          , Xu          , Uu          , Ql          , Ql          , Ql          , Kud         , Ql          , Kud         , Ql          , 9 Kud       , Ql          , Kud         , Ql          , Kud         , Ql          , Ql          , Ql          
Xu          , Xu          , Uh          , Uh          , Rr          , Rr          , Rr          , Cud         , Cud         , Cud         , Cud         , Cud         , Cud         , 8 Kud       , Cud         , Xu          , Xu          , Xu          , Uu^Uf       , Xu          , Xu          , Ql          , Ql          , Ql          , Ql          , Xu          , Uu          , Ql          , Ql          , Cud         , Cud         , Cud         , Cud         , Cud         , Cud         , Cud         , Cud         , Cud         , Cud         , Cud         , Ql          , Ql          
Xu          , Xu          , Rd          , Rd          , Xu          , Rr          , Xu          , Cud         , Cud         , Cud         , Cud         , Cud         , Cud         , Cud         , Cud         , Xu          , Uu^Uf       , Uu^Uf       , Qxu         , Uh          , Uh          , Xu          , Xu          , Ql          , Xu          , Xu          , Uu          , Ql          , Ql          , Cud         , Ql          , Cud         , Cud         , Cud         , Cud         , Cud         , Cud         , Cud         , Ql          , Cud         , Ql          , Ql          
Xu          , Xu          , Rd          , Rd          , Xu          , Qxu         , Xu          , Xu          , Xu          , Cud         , Cud         , Cud         , Xu          , Ql          , Xu          , Xu          , Uu          , Uu          , Uu          , Uh          , Xu          , Xu          , Xu          , Xu          , Xu          , Xu          , Uu          , Ql          , Ql          , Cud         , Ql          , Ql          , Ql          , Cud         , Cud         , Cud         , Ql          , Ql          , Ql          , Cud         , Ql          , Ql          
Xu          , Xu          , Rd          , Rd          , Xu          , Qxu         , Xu          , Cud         , Rr          , Xu          , Xu          , Xu          , Xu          , Xu          , Xu          , Uu          , Uu          , Uu          , Uu          , Xu          , Xu          , Xu          , Uh          , Uh          , Uu^Uf       , Xu          , Xu          , Uu          , Uu          , Cud         , Cud         , Ql          , Cud         , Cud         , Ql          , Cud         , Cud         , Ql          , Cud         , Cud         , Ql          , Ql          
Xu          , Xu          , Uh          , Rd          , Rd          , Xu          , Xu          , Rr          , Rr          , Cud         , Xu          , Xu          , Xu          , Uh          , Uu          , Uu          , Xu          , Xu          , Xu          , Uu          , Uu          , Uu          , Uu          , Qxu         , Uu^Uf       , Uu^Uf       , Xu          , Xu          , Xu          , Xu          , Xu          , Cud         , Xu          , Cud         , Cud         , Cud         , Xu          , Cud         , Ql          , Ql          , Xu          , Xu          
Xu          , Xu          , Xu          , Rd          , Rd          , Rd          , Rd          , Cud         , Xu          , Xu          , Xu          , Xu          , Uu          , Uu          , Uu^Uf       , Xu          , Xu          , Xu          , Xu          , Uu^Uf       , Uu          , Uu          , Xu          , Uu          , Xu          , Xu          , Ql          , Ql          , Ql          , Ql          , Ql          , Xu          , Cud         , Cud         , Ql          , Cud         , Cud         , Xu          , Xu          , Xu          , Xu          , Xu          
Xu          , Xu          , Rr          , Xu          , Rd          , Qxu         , Rd          , Xu          , Rr          , Rr          , Rr          , Cud         , Ql          , Uu          , Uu          , Xu          , Xu          , Xu          , Xu          , Xu          , Xu          , Uu          , Uu^Uf       , Xu          , Xu          , Xu          , Ql          , Uh          , Uu          , Uh          , Ql          , Xu          , Xu          , Cud         , Cud         , Cud         , Xu          , Xu          , Xu          , Xu          , Xu          , Xu          
Xu          , Xu          , Rr          , Cud         , Rd          , Rd          , Rd          , Xu          , Rr          , Rr          , Ql          , Xu          , Xu          , Xu          , Xu          , Uu          , Uu          , Xu          , Xu          , Xu          , Uu          , Uu          , Uu          , Xu          , Uh          , Xu          , Uh          , Uu          , Uu          , Uh          , Ql          , Xu          , Cud         , Cud         , Ql          , Cud         , Cud         , Xu          , Xu          , Xu          , Xu          , Xu          
Xu          , Xu          , Rr          , Xu          , Rd          , Qxu         , Rd          , Cud         , Rr          , Ql          , Uh          , Xu          , Xu          , Xu          , Uu          , Uu          , Xu          , Uu          , Xu          , Xu          , Uu          , Uh          , Uu          , Uu          , Uu          , Uh          , Xu          , Ql          , Ql          , Ql          , Xu          , Xu          , Xu          , Cud         , Cud         , Cud         , Xu          , Xu          , Xu          , Xu          , Xu          , Xu          
Xu          , Xu          , Rr          , Xu          , Rd          , Rd          , Rd          , Xu          , Rr          , Ql          , Ql          , Xu          , Uh          , Uh          , Xu          , Xu          , Xu          , Uu          , Xu          , Xu          , Uu^Uf       , Uu          , Xu          , Xu          , Uu          , Uu          , Xu          , Xu          , Xu          , Xu          , Xu          , Cud         , Cud         , Cud         , Ql          , Cud         , Cud         , Cud         , Xu          , Xu          , Xu          , Xu          
Xu          , Xu          , Xu          , Xu          , Rd          , Rd          , Rd          , Xu          , Xu          , Ql          , Xu          , Xu          , Uh          , Uu^Uf       , Xu          , Xu          , Xu          , Uu          , Xu          , Xu          , Xu          , Uu          , Qxu         , Xu          , Uu          , Uu          , Uu          , Xu          , Xu          , Cud         , Uu          , Uu          , Cud         , Cud         , Xu          , Cud         , Cud         , Uu          , Uu          , Cud         , Xu          , Xu          
Xu          , Xu          , Rr          , Xu          , Rd          , Rd          , Rd          , Xu          , Uu^Uf       , Xu          , Uh          , Uh          , Uu          , Uh          , Uu          , Xu          , Uh          , Uu          , Xu          , Xu          , Uu^Uf       , Uu          , Xu          , Xu          , Uu^Uf       , Uu          , Uu          , Xu          , Uu          , Uu          , Uu          , Ql          , Xu          , Xu          , Uu          , Xu          , Xu          , Ql          , Uu          , Uu          , Xu          , Xu          
Xu          , Xu          , Rr          , Cud         , Rd          , Rd          , Rd          , Xu          , Uu^Uf       , Uu          , Uu          , Xu          , Xu          , Uu          , Uh          , Uu          , Uh          , Uh          , Uh          , Uh          , Uu          , Uu          , Xu          , Xu          , Uu^Uf       , Uu          , Uu          , Uu          , Uu          , Uu          , Xu          , Xu          , Uu          , Xu          , Cud         , Xu          , Xu          , Uh          , Uh          , Uu^Uf       , Xu          , Xu          
Xu          , Xu          , Rr          , Xu          , Rd          , Rd          , Rd          , Xu          , Xu          , Uu^Uf       , Xu          , Xu          , Xu          , Xu          , Xu          , Xu          , Xu          , Xu          , Xu          , Uh          , Xu          , Uu          , Xu          , Xu          , Xu          , Xu          , Xu          , Uu          , Uu          , Xu          , Cud         , Uu          , Cud         , Uu          , Xu          , Ql          , Xu          , Ql          , Xu          , Xu          , Xu          , Xu          
Xu          , Xu          , Rr          , Xu          , Xu          , Rd          , Xu          , Xu          , Xu          , Xu          , Xu          , Xu          , Mm          , Xu          , Mm          , Xu          , Xu          , Xu          , Xu          , Xu          , Xu          , Xu          , Xu          , Xu          , Xu          , Xu          , Xu          , Uu          , Uu          , Xu          , Uu          , Xu          , Ql          , Xu          , Ql          , Xu          , Ql          , Ql          , Ql          , Ql          , Ql          , Ql          
Xu          , Xu          , Xu          , Xu          , Xu          , Uu          , Xu          , Xu          , Xu          , Xu          , Hh          , Hh          , Ww          , Hh          , Ss          , Ss          , Hh          , Xu          , Uh          , Xu          , Uu          , Xu          , Mm^Xm       , Mm^Xm       , Mm^Xm       , Xu          , Xu          , Uu          , Uu          , Uu          , Xu          , Xu          , Xu          , Ql          , Xu          , Ql          , Xu          , Ql          , Xu          , Xu          , Ql          , Ql          
Xu          , Xu          , Xu          , Xu          , Xu          , Uu          , Cud         , Mm^Xm       , Mm          , Mm          , Ss          , Ww          , Ww          , Ss          , Ww          , Rd          , Ss          , Mm          , Xu          , Uu          , Uu          , Xu          , Mm^Xm       , Wo          , Wo          , Mm^Xm       , Xu          , Uu          , Uu^Uf       , Uu          , Uh          , Ql          , Ql          , Xu          , Ql          , Xu          , Ql          , Ql          , Uh          , Xu          , Xu          , Xu          
Xu          , Xu          , Xu          , Xu          , Mm^Xm       , Cud         , Re          , Ss          , Rd          , Ww          , Wo          , Wo          , Chr         , Wo          , Wo          , Ww          , Rd          , Hh          , Xu          , Uu          , Uu          , Xu          , Xu          , Mm^Xm       , Wo          , Mm^Xm       , Xu          , Xu          , Xu          , Xu          , Xu          , Uh          , Xu          , Ql          , Xu          , Ql          , Uh          , Ql          , Xu          , Xu          , Xu          , Xu          
Xu          , Xu          , Xu          , Xu          , Mm          , Ss          , Ss          , Re          , Ss          , Ww          , Ww^Bw/      , Chr         , 6 Kh        , Chr         , Wo          , Ss          , Ss          , Ss          , Ss          , Xu          , Xu          , Xu          , Xu          , Mm^Xm       , Wo          , Mm^Xm       , Xu          , Xu          , Ql          , Ql          , Ql          , Xu          , Ql          , Xu          , Ql          , Ql          , Ql          , Ql          , Ql          , Ql          , Ql          , Ql          
Xu          , Xu          , Xu          , Mm^Xm       , Ss          , Ss          , Re          , Re          , Re          , Ww^Bw/      , Wo          , Chr         , Chr         , Chr         , Chs         , Chs         , Chs         , Ss          , Rd          , Ss          , Ss          , Mm          , Mm          , Mm^Xm       , Wo          , Mm^Xm       , Mm^Xm       , Xu          , Xu          , Xu          , Xu          , Ql          , Xu          , Ql          , Xu          , Xu          , Cud         , Xu          , Xu          , Xu          , Ql          , Ql          
Xu          , Xu          , Xu          , Mm          , Re          , Re          , Ss          , Ss          , Ss          , Ss          , Rd          , Ww          , Wo          , Wo          , Chr         , Kh          , Chs         , Re          , Re          , Ss          , Re          , Hh          , Re          , Wwf         , Wo          , Wwf         , Mm          , Xu          , Xu          , Xu          , Cud         , Xu          , Xu          , Ql          , Xu          , Cud         , Xu          , Cud         , Cud         , Xu          , Uh          , Uh          
Xu          , Xu          , Mm          , Ss          , Re          , Ss          , Xu          , Xu          , Xu          , Ss          , Ss          , Ss          , Ww          , Ww          , Rd          , Chs         , Re          , Re          , Ss          , Re          , Ss          , Re          , Ss          , Wwf         , Wwf         , Wwf         , Mm          , Xu          , Cud         , Cud         , Cud         , Cud         , Cud         , Xu          , Cud         , Cud         , Xu          , Xu          , Cud         , Xu          , Uh          , Uh          
Xu          , Xu          , Ss          , Ss          , Re          , Ss          , Xu          , Xu          , Xu          , Xu          , Xu          , Ss          , Hh          , Ss          , Hh          , Ss          , Hh          , Ss          , Hh          , Ss          , Mm          , Xu          , Xu          , Wwf         , Wwf         , Wwf         , Wwf         , Gs          , Xu          , Xu          , Cud         , Xu          , Xu          , Cud         , Xu          , Xu          , Ql          , Xu          , Cud         , Xu          , Xu          , Xu          
Xu          , Xu          , Mm          , Ss          , Re          , Ss          , Mm          , Xu          , Xu          , Ql          , Ql          , Xu          , Xu          , Mm          , Xu          , Mm          , Mm          , Mm          , Mm          , Mm          , Xu          , Uh          , Uu          , Xu          , Xu          , Wwf         , Wwf         , Gs^Fp       , Xu          , Xu          , Cud         , Xu          , Cud         , Cud         , Xu          , Ql          , Xu          , Xu          , Cud         , Xu          , Xu          , Xu          
Xu          , Xu          , Mm^Xm       , Ss          , Ss          , Re          , Re          , Mm^Xm       , Xu          , Ql          , Xu          , Ql          , Uu          , Xu          , Uu          , Xu          , Xu          , Xu          , Mm^Xm       , Xu          , Uu          , Uu          , Xu          , Xu          , Mm          , Wwf         , Wwf         , Mm          , Xu          , Ql          , Cud         , Cud         , Ql          , Xu          , Ql          , Ql          , Xu          , Xu          , Cud         , Xu          , Mm          , Mm          
Xu          , Xu          , Xu          , Mm          , Xu          , Ss          , Re          , Mm          , Mm          , Xu          , Xu          , Uu          , Xu          , Cud         , Xu          , Uu          , Ql          , Xu          , Xu          , Xu          , Xu          , Xu          , Xu          , Gs^Fp       , Wwf         , Wwf         , Mm          , Mm          , Xu          , Ql          , Ql          , Ql          , Uh          , Ql          , Xu          , Xu          , Cud         , Cud         , Xu          , Xu          , Gs^Fp       , Gs^Fp       
Xu          , Xu          , Ql          , Xu          , Uu          , Mm          , Ss          , Re          , Re          , Mm^Xm       , Mm          , Xu          , Xu          , Uu          , Xu          , Ql          , Ql          , Ql          , Ql          , Xu          , Xu          , Xu          , Mm          , Mm          , Wwf         , Wwf         , Gs^Fp       , Xu          , Xu          , Xu          , Xu          , Xu          , Xu          , Xu          , Cud         , Cud         , Xu          , Xu          , Gs          , Gs^Fp       , Gs^Fp       , Gs^Fp       
Ql          , Ql          , Uu          , Uu          , Xu          , Xu          , Ss          , Ss          , Re          , Ss          , Mm          , Mm^Xm       , Xu          , Uu          , Xu          , Xu          , Xu          , Xu          , Ql          , Xu          , Xu          , Xu          , Gs^Fp       , Wwf         , Wwf         , Gs^Fp       , Xu          , Xu          , Cud         , Cud         , Cud         , Xu          , Cud         , Cud         , Xu          , Xu          , Gs          , Gs          , Gs          , Gs          , Re          , Re          
Ql          , Ql          , Ql          , Xu          , Mm^Xm       , Mm          , Re          , Re          , Ss          , Ss          , Xu          , Xu          , Xu          , Uu          , Xu          , Xu          , Xu          , Ql          , Ql          , Ql          , Xu          , Gs^Fp       , Wwf         , Wwf         , Gs^Fp       , Mm          , Xu          , Xu          , Cud         , Xu          , Xu          , Cud         , Xu          , Xu          , Gs^Fp       , Gs          , 1 Kh        , 3 Kh        , 5 Kh        , Re          , Gs          , Gs          
Xu          , Xu          , Xu          , Xu          , Mm          , Ss          , Re          , Ss          , Ss          , Mm          , Xu          , Xu          , Cud         , Cud         , Qxu         , Xu          , Uu          , Ql          , Xu          , Ql          , Xu          , Mm          , Wwf         , Wwf         , Xu          , Xu          , Ql          , Xu          , Cud         , Xu          , Xu          , Xu          , Gs^Fp       , Gs^Fp       , Gs^Fp       , Gs          , Re          , Rr          , 4 Kh        , Gs          , Gg^Fet      , Gs^Fp       
Xu          , Xu          , Xu          , Xu          , Ss          , Re          , Ss          , Ss          , Xu          , Xu          , Xu          , Xu          , Cud         , Xu          , Qxu         , Xu          , Uu          , Xu          , Xu          , Xu          , Gs^Fp       , Wwf         , Wwf         , Wwf         , Xu          , Ql          , Uh          , Xu          , Cud         , Xu          , Cud         , Gs^Fp       , Gs          , Gs          , Re          , Re          , Gs          , 2 Kh        , Gs          , Gs          , Gs^Fp       , Gs^Fp       
Xu          , Xu          , Xu          , Xu          , Ss          , Re          , Ss          , Xu          , Ql          , Xu          , Xu          , Cud         , Cud         , Xu          , Xu          , Qxu         , Qxu         , Qxu         , Qxu         , Mm          , Mm          , Wwf         , Wwf         , Xu          , Xu          , Ql          , Ql          , Xu          , Xu          , Cud         , Xu          , Gs^Fp       , Re          , Re          , Gs^Fp       , Gs          , Gs^Fp       , Gs          , Gs^Fp       , Gs^Fp       , Gs^Fp       , Gs^Fp       
Xu          , Xu          , Xu          , Mm          , Re          , Re          , Mm          , Xu          , Ql          , Ql          , Cud         , Cud         , Cud         , Xu          , Xu          , Xu          , Xu          , Qxu         , Xu          , Qxu         , Qxu         , Mm^Xm       , Wwf         , Wwf         , Xu          , Xu          , Xu          , Xu          , Mm          , Xu          , Re          , Re          , Gs^Fp       , Gs          , Gs^Fp       , Gs^Fp       , Xu          , Gs^Fp       , Mm          , Gs^Fp       , Xu          , Xu          
Xu          , Xu          , Mm          , Ss          , Re          , Ss          , Xu          , Xu          , Xu          , Xu          , Cud         , 7 Kud       , Cud         , Cud         , Cud         , Xu          , Xu          , Qxu         , Qxu         , Xu          , Qxu         , Xu          , Mm          , Wwf         , Wwf         , Xu          , Re          , Re          , Re          , Re          , Mm          , Gs^Fp       , Gs^Fp       , Gs^Fp       , Mm^Xm       , Mm          , Xu          , Xu          , Xu          , Xu          , Xu          , Xu          
Xu          , Xu          , Mm^Xm       , Ss          , Re          , Ss          , Ss          , Xu          , Xu          , Xu          , Cud         , Cud         , Cud         , Xu          , Xu          , Cud         , Xu          , Xu          , Qxu         , Xu          , Qxu         , Xu          , Xu          , Gs^Fp       , Wwf         , Mm          , Re          , Gs^Fp       , Xu          , Xu          , Xu          , Xu          , Xu          , Gs^Fp       , Cud         , Xu          , Xu          , Xu          , Uu^Uf       , Xu          , Xu          , Xu          
Xu          , Xu          , Mm          , Ss          , Ss          , Re          , Re          , Ss          , Ss          , Xu          , Ss          , Cud         , Ss          , Xu          , Xu          , Cud         , Xu          , Xu          , Qxu         , Xu          , Qxu         , Xu          , Xu          , Gs^Fp       , Wwf         , Wwf         , Xu          , Xu          , Xu          , Xu          , Uu          , Uu          , Uu^Uf       , Xu          , Cud         , Xu          , Xu          , Uu^Uf       , Uu          , Qxu         , Xu          , Xu          
Xu          , Xu          , Xu          , Mm^Xm       , Mm^Xm       , Mm          , Mm^Xm       , Re          , Re          , Ss          , Re          , Re          , Ss          , Mm          , Xu          , Cud         , Qxu         , Xu          , Qxu         , Qxu         , Xu          , Uu          , Xu          , Mm          , Wwf         , Wwf         , Xu          , Xu          , Xu          , Uh          , Uu          , Uu          , Xu          , Xu          , Cud         , Xu          , Xu          , Uu          , Uu          , Uu          , Xu          , Xu          
Xu          , Xu          , Uu          , Xu          , Xu          , Xu          , Xu          , Xu          , Mm          , Re          , Ss          , Ss          , Mm          , Mm^Xm       , Xu          , Xu          , Qxu         , Qxu         , Xu          , Qxu         , Qxu         , Xu          , Qxu         , Xu          , Mm          , Wwf         , Mm          , Xu          , Xu          , Uh          , Uh          , Uu          , Cud         , Xu          , Cud         , Xu          , Cud         , Uu          , Uu          , Uh          , Xu          , Xu          
Uu          , Uu          , Xu          , Uu          , Uh          , Uh          , Uh          , Uh          , Xu          , Mm^Xm       , Xu          , Mm^Xm       , Xu          , Xu          , Xu          , Xu          , Uu          , Qxu         , Xu          , Qxu         , Xu          , Qxu         , Xu          , Qxu         , Xu          , Wwf         , Mm          , Xu          , Xu          , Xu          , Xu          , Xu          , Xu          , Cud         , Xu          , Cud         , Xu          , Xu          , Xu          , Uh          , Xu          , Xu          
Uu          , Uu          , Xu          , Uu          , Uh          , Uh          , Uh          , Uh          , Xu          , Mm^Xm       , Xu          , Mm^Xm       , Xu          , Xu          , Xu          , Xu          , Uu          , Qxu         , Xu          , Qxu         , Xu          , Qxu         , Xu          , Qxu         , Xu          , Wwf         , Mm          , Xu          , Xu          , Xu          , Xu          , Xu          , Xu          , Cud         , Xu          , Cud         , Xu          , Xu          , Xu          , Uh          , Xu          , Xu          
