border_size=1
usage=map

Qxu         , Qxu         , Qxu         , Qxu         , Qxu         , Qxu         , Qxu         , Qxu         , Qxu         , Qxu         , Qxu         , Qxu         , Qxu         , Qxu         , Qxu         , Qxu         , Qxu         , Qxu         , Qxu         , Qxu         , Qxu         , Qxu         , Qxu         , Qxu         , Qxu         , Qxu         , Qxu         , Qxu         , Qxu         , Qxu         , Qxu         
Qxu         , Qxu         , Qxu         , Qxu         , Qxu         , Qxu         , Qxu         , Qxu         , Qxu         , Qxu         , Qxu         , Qxu         , Qxu         , Qxu         , Qxu         , Qxu         , Qxu         , Qxu         , Qxu         , Qxu         , Qxu         , Qxu         , Qxu         , Qxu         , Qxu         , Qxu         , Qxu         , Qxu         , Qxu         , Qxu         , Qxu         
Qxu         , Qxu         , Xu          , Xu          , Xu          , Xu          , Xu          , Xu          , Xu          , Xu          , Xu          , Xu          , Xu          , Xu          , Xu          , Xu          , Xu          , Xu          , Xu          , Xu          , Xu          , Xu          , Xu          , Xu          , Xu          , Xu          , Xu          , Xu          , Xu          , Qxu         , Qxu         
Qxu         , Qxu         , Xu          , Xu          , Xu          , Rd          , Rd          , Xu          , Gs^Fp       , Gs^Fp       , Hh          , Mm          , Cud         , Xu          , Cud         , Xu          , Xu          , Xu          , Cud         , Xu          , Cud         , Mm          , Hh          , Gs^Fp       , Gs^Fp       , Xu          , Rd          , Rd          , Xu          , Qxu         , Qxu         
Qxu         , Qxu         , Xu          , Xu          , Xu          , Rd          , Cud         , Xu          , Ww          , Wwf         , Wwf         , Hh          , Cud         , Cud         , Cud         , Cud         , 9 Kud       , Cud         , Cud         , Cud         , Cud         , Hh          , Wwf         , Wwf         , Ww          , Xu          , Cud         , Rd          , Xu          , Qxu         , Qxu         
Qxu         , Qxu         , Xu          , Xu          , Xu          , Xu          , Gg          , Ww          , Hh          , Ww          , Ww          , Wwf         , Xu          , Cud         , Cud         , Cud         , Cud         , Cud         , Cud         , Cud         , Xu          , Wwf         , Ww          , Ww          , Hh          , Ww          , Gg          , Xu          , Xu          , Qxu         , Qxu         
Qxu         , Qxu         , Xu          , Xu          , Xu          , Gg          , Gg          , Ww          , Mm          , Mm          , Ww          , Wwf         , Xu          , Qxu         , Qxu         , Cud         , Xu          , Cud         , Qxu         , Qxu         , Xu          , Wwf         , Ww          , Mm          , Mm          , Ww          , Gg          , Gg          , Xu          , Qxu         , Qxu         
Qxu         , Qxu         , Xu          , Xu          , Xu          , Gs^Fp       , Gg          , Ww          , Ww          , Hh          , Ww          , Wwf         , Gs^Fp       , Xu          , Xu          , Xu          , Ql          , Xu          , Xu          , Xu          , Gs^Fp       , Wwf         , Ww          , Hh          , Ww          , Ww          , Gg          , Gs^Fp       , Xu          , Qxu         , Qxu         
Qxu         , Qxu         , Xu          , Xu          , Xu          , Gs^Fp       , Gg          , Gg          , Gs^Fp       , Ww          , Gg          , Wwf         , Wwf         , Gs^Fp       , Cud         , Ql          , Uu^Ii       , Ql          , Cud         , Gs^Fp       , Wwf         , Wwf         , Gg          , Ww          , Gs^Fp       , Gg          , Gg          , Gs^Fp       , Xu          , Qxu         , Qxu         
Qxu         , Qxu         , Xu          , Xu          , Xu          , Ww          , Ww^Bw|      , Hh          , Mm          , Gs^Fp       , Gg          , Ww          , Ww          , Wwf         , Xu          , Ql          , Ql          , Ql          , Xu          , Wwf         , Ww          , Ww          , Gg          , Gs^Fp       , Mm          , Hh          , Ww^Bw|      , Ww          , Xu          , Qxu         , Qxu         
Qxu         , Qxu         , Xu          , Xu          , Xu          , Ww          , Ww^Bw|      , Ww          , Ww          , Hh          , Gg          , Ww          , Gs^Fp       , Wwf         , Gg          , Xu          , Xu          , Xu          , Gg          , Wwf         , Gs^Fp       , Ww          , Gg          , Hh          , Ww          , Ww          , Ww^Bw|      , Ww          , Xu          , Qxu         , Qxu         
Qxu         , Qxu         , Xu          , Xu          , Xu          , Ww          , Ww^Bw|      , Ww          , Ww^Bw/      , Ww^Bw/      , Ww          , Gs^Fp       , Xu          , Xu          , Xu          , Gg          , Gg          , Gg          , Xu          , Xu          , Xu          , Gs^Fp       , Ww          , Ww^Bw\      , Ww^Bw\      , Ww          , Ww^Bw|      , Ww          , Xu          , Qxu         , Qxu         
Qxu         , Qxu         , Xu          , Xu          , Xu          , Xu          , Chw         , Ww^Bw/      , Ww          , Ww          , Xu          , Xu          , Xu          , Xu          , Gg          , Gg          , Gs^Fp       , Gg          , Gg          , Xu          , Xu          , Xu          , Xu          , Ww          , Ww          , Ww^Bw\      , Chw         , Xu          , Xu          , Qxu         , Qxu         
Qxu         , Qxu         , Xu          , Xu          , Xu          , Wwf         , Wwf         , Xu          , Xu          , Xu          , Xu          , Xu          , Wwf         , Gg          , Hh          , Gs^Fp       , Mm          , Gs^Fp       , Hh          , Gg          , Wwf         , Xu          , Xu          , Xu          , Xu          , Xu          , Wwf         , Wwf         , Xu          , Qxu         , Qxu         
Qxu         , Qxu         , Xu          , Xu          , Xu          , Wwf         , Xu          , Xu          , Xu          , Xu          , Wwf         , Wwf         , Mm          , Xu          , Cud         , Ss          , Cud         , Ss          , Cud         , Xu          , Mm          , Wwf         , Wwf         , Xu          , Xu          , Xu          , Xu          , Wwf         , Xu          , Qxu         , Qxu         
Qxu         , Qxu         , Xu          , Xu          , Xu          , Xu          , Xu          , Xu          , Wwf         , Wwf         , Mm          , Mm^Xm       , Hh          , Xu          , Cud         , Cud         , Cud         , Cud         , Cud         , Xu          , Hh          , Mm^Xm       , Mm          , Wwf         , Wwf         , Xu          , Xu          , Xu          , Xu          , Qxu         , Qxu         
Qxu         , Qxu         , Xu          , Xu          , Xu          , Xu          , Ww          , Ww          , Wwf         , Xu          , Xu          , Hh          , Cud         , Xu          , Cud         , Cud         , 8 Kud       , Cud         , Cud         , Xu          , Cud         , Hh          , Xu          , Xu          , Wwf         , Wwf         , Wwf         , Xu          , Xu          , Qxu         , Qxu         
Qxu         , Qxu         , Xu          , Xu          , Xu          , Ww          , Mm          , Mm^Xm       , Mm^Xm       , Wwf         , Gs^Fp       , Xu          , Xu          , Xu          , Xu          , Cud         , Cud         , Cud         , Xu          , Xu          , Xu          , Xu          , Gs^Fp       , Ww          , Mm^Xm       , Mm^Xm       , Mm          , Wwf         , Xu          , Qxu         , Qxu         
Qxu         , Qxu         , Xu          , Xu          , Xu          , Ww          , Mm^Xm       , Hh          , Wwf         , Wwf         , Xu          , Xu          , Rd          , Rd          , Rd          , Xu          , Xu          , Xu          , Rd          , Rd          , Rd          , Xu          , Xu          , Ww          , Ww          , Hh          , Mm^Xm       , Wwf         , Xu          , Qxu         , Qxu         
Qxu         , Qxu         , Xu          , Xu          , Xu          , Ww          , Hh          , Mm^Xm       , Wwf         , Xu          , Aa          , Aa          , Ms          , Ms^Xm       , Ha          , Aa          , Aa          , Aa          , Ha          , Ms^Xm       , Ms          , Aa          , Aa          , Xu          , Ww          , Mm^Xm       , Hh          , Wwf         , Xu          , Qxu         , Qxu         
Qxu         , Qxu         , Xu          , Xu          , Xu          , Wwf         , Mm^Xm       , Mm          , Wwf         , Xu          , Aa          , Aa^Fpa      , Ha          , Ms^Xm       , Ms          , Aa^Fpa      , Qxu         , Aa^Fpa      , Ms          , Ms^Xm       , Ha          , Aa^Fpa      , Aa          , Xu          , Wwf         , Mm          , Mm^Xm       , Wwf         , Xu          , Qxu         , Qxu         
Qxu         , Qxu         , Xu          , Xu          , Xu          , Wwf         , Wwf         , Mm^Xm       , Wwf         , Ai          , Aa          , Aa          , Aa          , Ms^Xm       , Aa^Fpa      , Aa^Fpa      , Aa          , Aa^Fpa      , Aa^Fpa      , Ms^Xm       , Aa          , Aa          , Aa          , Ai          , Wwf         , Mm^Xm       , Wwf         , Wwf         , Xu          , Qxu         , Qxu         
Qxu         , Qxu         , Xu          , Xu          , Xu          , Wwf         , Wwf         , Wwf         , Ai          , Ai          , Aa^Fpa      , Aa          , Rd          , Rd          , Aa          , Aa          , Xu          , Aa          , Aa          , Rd          , Rd          , Aa          , Aa^Fpa      , Ai          , Ai          , Wwf         , Wwf         , Wwf         , Xu          , Qxu         , Qxu         
Qxu         , Qxu         , Xu          , Xu          , Xu          , Xu          , Ai          , Ai          , Ha          , Ha          , Aa^Fpa      , Xu          , Xu          , Xu          , Aa          , Xu          , Rd          , Xu          , Aa          , Xu          , Xu          , Xu          , Aa^Fpa      , Ha          , Ha          , Ai          , Ai          , Xu          , Xu          , Qxu         , Qxu         
Qxu         , Qxu         , Xu          , Xu          , Xu          , Xu          , Xu          , Aa^Fpa      , Aa^Fpa      , Ms          , Xu          , Xu          , Xu          , Aa^Fpa      , Aa^Fpa      , Rd          , Rd          , Rd          , Aa^Fpa      , Aa^Fpa      , Xu          , Xu          , Xu          , Ms          , Aa^Fpa      , Aa^Fpa      , Xu          , Xu          , Xu          , Qxu         , Qxu         
Qxu         , Qxu         , Xu          , Xu          , Xu          , Xu          , Hh          , Xu          , Xu          , Xu          , Xu          , Xu          , Chs         , Xu          , Xu          , Chr         , Chr         , Chr         , Xu          , Xu          , Uh          , Xu          , Xu          , Xu          , Xu          , Xu          , Xu          , Xu          , Xu          , Qxu         , Qxu         
Qxu         , Qxu         , Xu          , Xu          , Hh          , Mm          , Gs          , Gs^Ft       , Gs          , Xu          , Ss          , Chs         , Ss          , Ss          , Ss          , Xu          , Chr         , Xu          , Uu          , Uh          , Uu          , Uu^Uf       , Uh          , Xu          , Xu          , Xu          , Xu          , Xu          , Xu          , Qxu         , Qxu         
Qxu         , Qxu         , Xu          , Xu          , Gs^Ft       , Gs          , Gs^Ft       , Gs          , Gs^Ft       , Xu          , Ss          , Ss          , Ss          , Ss          , Gs^Ft       , Xu          , Chr         , Xu          , Uu          , Uu          , Qxu         , Uu          , Uu          , Xu          , Uu          , Uh          , Uu^Uf       , Xu          , Xu          , Qxu         , Qxu         
Qxu         , Qxu         , Xu          , Xu          , Gs^Ft       , Gs          , Gs          , Hh          , Mm          , Gs^Ft       , Gs          , Ss          , Gs          , Gs^Ft       , Chr         , Chr         , 7 Kh        , Chr         , Chr         , Uu^Uf       , Uh          , Uu          , Uu          , Cud         , Uu          , Uu^Ii       , Uu^Uf       , Xu          , Xu          , Qxu         , Qxu         
Qxu         , Qxu         , Xu          , Xu          , Mm          , Hh          , Gs          , Hh          , Gs^Ft       , Gs          , Gs          , Gs          , Gs          , Chr         , Chr         , Chr         , Chr         , Chr         , Chr         , Chr         , Uu          , Uu          , Uh          , Xu          , Xu          , Uh          , Xu          , Xu          , Xu          , Qxu         , Qxu         
Qxu         , Qxu         , Xu          , Xu          , Gs^Ft       , Hh          , Gs^Ft       , Gs          , Gs^Ft       , Gs^Ft       , Ss          , Ss          , Ss          , Gs^Ft       , Gs^Ft       , Chr         , Chr         , Chr         , Xu          , Uh          , Uh          , Uu^Uf       , Xu          , Xu          , Xu          , Xu          , Xu          , Xu          , Xu          , Qxu         , Qxu         
Qxu         , Qxu         , Xu          , Xu          , Gs          , Gs          , Gs          , Gs          , Hh          , Xu          , Ss          , Ss          , Ss          , Ss          , Ss          , Xu          , Chr         , Xu          , Xu          , Xu          , Xu          , Xu          , Md          , Xu          , Xu          , Xu          , Xu          , Xu          , Xu          , Qxu         , Qxu         
Qxu         , Qxu         , Xu          , Cud         , Xu          , Gs^Ft       , Hh          , Mm          , Xu          , Xu          , Xu          , Chs         , Chs         , Ss          , Xu          , Xu          , Chr         , Xu          , Xu          , Xu          , Hd          , Md          , Dd^Ft       , Gs          , Hd          , Xu          , Xu          , Xu          , Xu          , Qxu         , Qxu         
Qxu         , Qxu         , Xu          , Re          , Re          , Xu          , Xu          , Xu          , Xu          , Uu          , Xu          , Xu          , Xu          , Xu          , Dd          , Chr         , Dd          , Chr         , Gs          , Dd^Ft       , Gs          , Hd          , Dd          , Dd          , Dd^Ft       , Md          , Ss          , Xu          , Xu          , Qxu         , Qxu         
Qxu         , Qxu         , Xu          , Re          , Re          , Re          , Xu          , Uu          , Cud         , Cud         , Cud         , Uu          , Xu          , Dd^Ft       , Dd          , Dd          , Hd          , Gs          , Gs          , Gs          , Dd^Ft       , Gs          , Dd          , Dd          , Hd          , Md          , Md          , Md          , Xu          , Qxu         , Qxu         
Qxu         , Qxu         , Xu          , Re          , Re          , Re          , Xu          , Xu          , Cud         , Xu          , Cud         , Xu          , Xu          , Dd^Ft       , Dd          , Hd          , Md          , Dd^Ft       , Xu          , Hd          , Md          , Dd^Ft       , Dd          , Dd          , Dd          , Dd^Ft       , Hd          , Dd^Ft       , Xu          , Qxu         , Qxu         
Qxu         , Qxu         , Xu          , Xu          , Xu          , Xu          , Gg          , Gs^Fp       , Mm^Xm       , Hh          , Mm^Xm       , Gs^Fp       , Gg          , Xu          , Xu          , Dd^Ft       , Xu          , Xu          , Rd          , Xu          , Xu          , Hd          , Xu          , Dd          , Dd          , Dd          , Dd          , Dd          , Xu          , Qxu         , Qxu         
Qxu         , Qxu         , Xu          , Xu          , Hh          , Gg          , Wwf         , Wwf         , Wwf         , Mm          , Wwf         , Wwf         , Wwf         , Hh          , Mm          , Xu          , Xu          , Rd          , Rd          , Rd          , Xu          , Xu          , Dd^Ft       , Dd          , Dd          , Dd          , Dd          , Dd          , Xu          , Qxu         , Qxu         
Qxu         , Qxu         , Xu          , Mm          , Gs^Fp       , Wwf         , Wwf         , Wwf         , Mm^Xm       , Wwf         , Mm^Xm       , Wwf         , Wwf         , Gs^Fp       , Hh          , Mm          , Hh          , Xu          , Xu          , Xu          , Hd          , Md          , Hd          , Gs          , Dd^Ft       , Dd^Ft       , Dd^Ft       , Dd          , Xu          , Qxu         , Qxu         
Qxu         , Qxu         , Xu          , Hh          , Gs^Fp       , Wwf         , Wwf         , Gs^Fp       , Hh          , Mm          , Hh          , Wwf         , Wwf         , Wwf         , Wwf         , Mm          , Gs^Fp       , Gs^Fp       , Xu          , Dd^Ft       , Gs          , Dd^Ft       , Gs          , Gs          , Md          , Hd          , Md          , Hd          , Xu          , Qxu         , Qxu         
Qxu         , Qxu         , Xu          , Mm          , Hh          , Wwf         , Gs^Fp       , Gs^Fp       , Xu          , Xu          , Xu          , Wwf         , Gs^Fp       , Wwf         , Wwf         , Wwf         , Hh          , Gs^Fp       , Xu          , Dd^Ft       , Hd          , Gs          , Dd          , Hd          , Md          , Md          , Xu          , Xu          , Xu          , Qxu         , Qxu         
Qxu         , Qxu         , Xu          , Xu          , Xu          , Wwf         , Xu          , Xu          , Ss          , Re          , Ss          , Xu          , Xu          , Gs^Fp       , Gg          , Hh          , Mm          , Hh          , Xu          , Hd          , Md          , Hd          , Dd          , Hd          , Xu          , Xu          , Xu          , Xu          , Xu          , Qxu         , Qxu         
Qxu         , Qxu         , Xu          , Xu          , Xu          , Cud         , Xu          , Xu          , Xu          , Ss          , Xu          , Xu          , Xu          , Gs^Fp       , Ss^Bw|      , Ss          , Ss          , Mm          , Xu          , Md          , Ss          , Ss          , Ss^Bw|      , Gs^Fp       , Xu          , Xu          , Xu          , Xu          , Xu          , Qxu         , Qxu         
Qxu         , Qxu         , Xu          , Xu          , Rd          , Wwf         , Rd          , Xu          , Xu          , Ss          , Ss          , Xu          , Ss          , Ss          , Ss^Bw|      , Ss          , Ss          , Ss          , Chs         , Ss          , Ss          , Ss          , Ss^Bw|      , Ss          , Ss          , Xu          , Xu          , Xu          , Xu          , Qxu         , Qxu         
Qxu         , Qxu         , Xu          , Rd          , 5 Rd        , Wwf         , 4 Rd        , Rd          , Xu          , Xu          , Xu          , Ss          , Ss          , Ss          , Ss          , Ss^Bw\      , Ss^Bw\      , Chs         , 6 Kh        , Chs         , Ss^Bw/      , Ss^Bw/      , Ss          , Ss          , Ss          , Ss          , Xu          , Xu          , Xu          , Qxu         , Qxu         
Qxu         , Qxu         , Xu          , Rd          , 3 Rd        , Wwf         , 2 Rd        , Rd          , Xu          , Xu          , Xu          , Ds          , Ds          , Ss          , Ss          , Ss          , Ss          , Chs         , Chs         , Chs         , Ss          , Ss          , Ss          , Ss          , Ds          , Ds          , Xu          , Xu          , Xu          , Qxu         , Qxu         
Qxu         , Qxu         , Xu          , Rd          , Rd          , Wwf         , Rd          , Rd          , Xu          , Xu          , Xu          , Re          , Ds          , Ss          , Ss          , Ss          , Ss          , Chs         , Xu          , Chs         , Ss          , Ss          , Ss          , Ss          , Ds          , Re          , Xu          , Xu          , Xu          , Qxu         , Qxu         
Qxu         , Qxu         , Xu          , Xu          , Xu          , 1 Wwf       , Xu          , Xu          , Xu          , Xu          , Xu          , Xu          , Xu          , Ss          , Xu          , Xu          , Xu          , Xu          , Xu          , Xu          , Xu          , Xu          , Xu          , Ss          , Xu          , Xu          , Xu          , Xu          , Xu          , Qxu         , Qxu         
Qxu         , Qxu         , Qxu         , Xu          , Qxu         , Xu          , Qxu         , Xu          , Qxu         , Xu          , Qxu         , Xu          , Qxu         , Xu          , Qxu         , Xu          , Qxu         , Xu          , Qxu         , Xu          , Qxu         , Xu          , Qxu         , Xu          , Qxu         , Xu          , Qxu         , Xu          , Qxu         , Qxu         , Qxu         
Qxu         , Qxu         , Qxu         , Qxu         , Qxu         , Qxu         , Qxu         , Qxu         , Qxu         , Qxu         , Qxu         , Qxu         , Qxu         , Qxu         , Qxu         , Qxu         , Qxu         , Qxu         , Qxu         , Qxu         , Qxu         , Qxu         , Qxu         , Qxu         , Qxu         , Qxu         , Qxu         , Qxu         , Qxu         , Qxu         , Qxu         
Qxu         , Qxu         , Qxu         , Qxu         , Qxu         , Qxu         , Qxu         , Qxu         , Qxu         , Qxu         , Qxu         , Qxu         , Qxu         , Qxu         , Qxu         , Qxu         , Qxu         , Qxu         , Qxu         , Qxu         , Qxu         , Qxu         , Qxu         , Qxu         , Qxu         , Qxu         , Qxu         , Qxu         , Qxu         , Qxu         , Qxu         
