border_size=1
usage=map

Uu^Ii       , Uu^Ii       , Uu^Ii       , Mm          , Ql          , Ql          , Ql          , Ql          , Ql          , Ql          , Ql          , Ql          , Cud         , Uu^Uf       , Uu^Uf       , Uu^Uf       , Cud         , Cud         , Cud         , Cud         , Xu          , Xu          
Uu^Ii       , Uu^Ii       , Uu^Ii       , Mm          , Ql          , Ql          , Ql          , Ql          , Ql          , Ql          , Ql          , Ql          , Cud         , Uu^Uf       , Uu^Uf       , Uu^Uf       , Cud         , Cud         , Cud         , Cud         , Xu          , Xu          
Rr          , Rr          , Rr          , Xu          , Xu          , Cud         , Xu          , Cud         , Xu          , Xu          , Xu          , Xu          , Uu^Uf       , Uu^Uf       , Cud         , Uu^Uf       , Cud         , Cud         , 9 Kud       , Cud         , Xu          , Xu          
Rr          , Rr          , Rr          , Re          , Rr          , Re          , Rr          , Rr          , Rr          , Ce          , Gg          , Ss          , Ss          , Uu^Uf       , Xu          , Xu          , Cud         , Cud         , Cud         , Cud         , Xu          , Xu          
Rr          , Rr          , Xu          , Rr          , Ce          , Rr          , Xu          , Re          , Xu          , Ce          , Xu          , Gg          , Gg          , Ss          , Ss          , Xu          , Cud         , Ss          , Ss          , Cud         , Xu          , Xu          
Xu          , Xu          , Ce          , Xu          , Ce          , Xu          , Ce          , Xu          , Mm          , Xu          , Mm          , Xu          , Hh          , Ss          , Ss          , Xu          , Xu          , Cud         , Cud         , Cud         , Xu          , Xu          
Xu          , Xu          , Gg^Fet      , Ce          , Ce          , Ce          , Gg^Fet      , Xu          , Mm          , Chs         , 8 Kh        , Chs         , Ss          , Wwf         , Wwf         , Hh          , Uu^Ii       , Xu          , Xu          , Xu          , Xu          , Xu          
Xu          , Xu          , Xu          , Mm^Xm       , Xu          , Mm^Xm       , Xu          , Xu          , Mm          , Chs         , Ww          , Chs         , Wwf         , Wwf         , Wwf         , Wwf         , Wwf         , Wwf         , Wwf         , Xu          , Xu          , Xu          
Xu          , Xu          , Ss          , Xu          , Ss          , Xu          , Ww          , Ww          , Ww          , Ww          , Ww          , Ww          , Xu          , Wwf         , Wwf         , Wwf         , Wwf         , Wwf         , Wwf         , Xu          , Xu          , Xu          
Xu          , Xu          , Xu          , Ss          , Xu          , Xu          , Xu          , Xu          , Xu          , Xu          , Xu          , Xu          , Wwf         , Xu          , Xu          , Xu          , Xu          , Wwf         , Wwf         , Xu          , Xu          , Xu          
Xu          , Xu          , Xu          , Ss          , Gs^Fp       , Gs^Fp       , Gs^Fp       , Gs^Fp       , Rr          , Xu          , Rd          , Wwf         , Xu          , Rd          , Rd          , Rd          , 5 Kh        , Xu          , Uu^Uf       , Xu          , Xu          , Xu          
Xu          , Xu          , Gs^Fp       , Ww          , Ww          , Rr          , Wwf         , Rr          , Rr          , Rr          , Rr          , Rr          , Chw         , Xu          , Xu          , 4 Kh        , Xu          , Xu          , Cud         , Xu          , Wo          , Wo          
Xu          , Xu          , Gs^Fp       , Gs^Fp       , Ww          , Rr          , Rr          , Wwf         , Xu          , Rr          , Rr          , Chw         , Xu          , Ww^Bw\      , Ww^Bw\      , Xu          , Chs         , Xu          , Wwf         , Xu          , Wo          , Wo          
Xu          , Xu          , Xu          , Ww          , Rr          , Rr          , Xu          , Xu          , Xu          , Xu          , Xu          , Xu          , Ss          , Xu          , Xu          , Ww^Bw\      , Ww^Bw\      , Ww          , Wwf         , Aa^Fpa      , Ww          , Ww          
Xu          , Xu          , Xu          , Xu          , Cud         , Xu          , Dd          , Xu          , Xu          , Xu          , Mm          , Xu          , Ss          , Xu          , Ss          , Xu          , Ww^Bw/      , Ww^Bw/      , Ww^Bw\      , Aa^Fpa      , Aa^Fpa      , Aa^Fpa      
Xu          , Xu          , Xu          , Xu          , Rd          , Xu          , Xu          , Wwf         , Ww^Bw|      , Ww^Bw/      , Xu          , Xu          , Ww^Bw|      , Ss          , Xu          , Xu          , Xu          , Xu          , Hh          , Hh          , Ss          , Ss          
Xu          , Xu          , Rd          , Rd          , Rd          , Rd          , Rd          , Xu          , Ww^Bw|      , Xu          , Xu          , Xu          , Ww^Bw/      , Rr          , Rr          , Xu          , Xu          , Xu          , Ss          , Ss          , Ss          , Ss          
Xu          , Xu          , Rd          , 1 Kh        , Rd          , 2 Kh        , Dd^Do       , Xu          , Ww^Bw|      , Xu          , Ww^Bw/      , Ww^Bw/      , Rr          , Xu          , Xu          , Cud         , Xu          , Xu          , Ss          , Chw         , Ss          , Ss          
Xu          , Xu          , Rd          , Rd          , 3 Kh        , Dd          , Hd          , Xu          , Ww^Bw|      , Ww^Bw/      , Xu          , Xu          , Xu          , Rr          , Cud         , Xu          , Chs         , Chs         , Chs         , Ss          , Ss          , Ss          
Xu          , Xu          , Xu          , Rd          , Rd          , Dd^Do       , Xu          , Xu          , Ww^Bw|      , Xu          , Xu          , Xu          , Xu          , Xu          , Xu          , Xu          , Chs         , 7 Kh        , Chw         , Chw         , Chw         , Chw         
Xu          , Xu          , Xu          , Xu          , Xu          , Xu          , Xu          , Xu          , Hh          , Hh          , Hh          , Hh          , Gs^Fp       , Gs^Fp       , Gs^Fp       , Gs^Fp       , Gg          , 6 Kh        , Chw         , Chw         , Chw         , Chw         
Xu          , Xu          , Xu          , Xu          , Xu          , Xu          , Xu          , Xu          , Hh          , Hh          , Hh          , Hh          , Gs^Fp       , Gs^Fp       , Gs^Fp       , Gs^Fp       , Gg          , Ch          , Chw         , Chw         , Chw         , Chw         
