border_size=1
usage=map

Ch          , Ch          , Ch          , Ch          , Ch          , Ch          , Ch          , Ch          , Ch          , Ch          , Md^Xm       , Mm^Xm       , Mm^Xm       , Mm^Xm       , Mm^Xm       , Mm^Xm       , Mm^Xm       , Mm^Xm       , Mm^Xm       , Mm^Xm       , Mm^Xm       , Mm^Xm       , Mm^Xm       , Mm^Xm       , Mm^Xm       , Mm^Xm       , Mm^Xm       , Mm^Xm       , Gs          , Gs          , Gs          , Uu^Ii       , Uu          , Uu          , Uu          , Uu          , Uu          , Cud         , Cud         , Cud         , Cud         , Cud         , Mm^Xm       , Mm^Xm       , Mm^Xm       , Mm^Xm       , Mm^Xm       , Mm^Xm       , Mm^Xm       , Ce          , Ce          , Ce          , Ce          , Ce          , Ce          , Ce          
Ch          , Ch          , Ch          , Ch          , Ch          , 9 Kh        , Ch          , Ch          , Ch          , Ch          , Md^Xm       , Hd          , Gg^Efm      , Mm^Xm       , Mm^Xm       , Mm^Xm       , Gg^Efm      , Gs^Ft       , Mm^Xm       , Mm^Xm       , Rp          , Gg          , Mm^Xm       , Mm^Xm       , Mm^Xm       , Mm^Xm       , Uu          , Uu^Ii       , Uu^Ii       , Gs          , Uu^Ii       , Uh^Ii       , Uu          , Uu          , Uu          , Uh          , Uu          , Cud         , Cud         , Cud         , Cud         , Cud         , Mm^Xm       , Mm^Xm       , Mm^Xm       , Mm^Xm       , Gs          , Gs          , Mm^Xm       , Ce          , Ce          , Ce          , Ce          , Ce          , 6 Ke        , Ce          
Ch          , Ch          , Ch          , Ch          , Ch          , Ch          , Ch          , Ch          , Ch          , Ch          , Md^Xm       , Md^Xm       , Gs          , Gs          , Mm^Xm       , Gs          , Gs          , Mm^Xm       , Mm^Xm       , Gg          , Gg          , Gg          , Mm^Xm       , Mm^Xm       , Uu          , Uu          , Uh          , Uu          , Uu          , Uh^Ii       , Uu          , Uu          , Uu^Uf       , Uh          , Uu          , Uu          , Uu          , Cud         , Cud         , Cud         , 8 Kud       , Cud         , Mm^Xm       , Uu          , Mm^Xm       , Rp          , Gs          , Gs          , Mm^Xm       , Ce          , Ce          , Ce          , Ce          , Ce          , Ce          , Ce          
Ch          , Ch          , Ch          , Ch          , Ch          , Ch          , Ch          , Ch          , Ch          , Ch          , Md^Xm       , Gs^Ft       , Md^Xm       , Gs          , Mm^Xm       , Gs          , Mm^Xm       , Hd          , Mm^Xm       , Mm^Xm       , Mm^Xm       , Mm^Xm       , Uu          , Uu^Uf       , Uu          , Uh          , Uu          , Uu          , Uh          , Uh          , Uu          , Uu          , Uu          , Uu          , Uh          , Uh          , Uu          , Cud         , Cud         , Cud         , Cud         , Cud         , Mm^Xm       , Mm^Xm       , Mm^Xm       , Mm^Xm       , Mm^Xm       , Gs          , Mm^Xm       , Ce          , Gs          , Ce          , Gs          , Ce          , Gs          , Ce          
Ds          , Ch          , Ds          , Ds          , Ds          , Ch          , Ds          , Ds          , Dd          , Ch          , Md^Xm       , Md^Xm       , Mm          , Gs^Ft       , Mm^Xm       , Hd          , Hd          , Mm^Xm       , Mm^Xm       , Mm^Xm       , Uu          , Uu          , Uh          , Uu          , Uu          , Uu          , Uu          , Uu^Uf       , Uu          , Uh          , Uu          , Uu          , Uu          , Uu          , Uu          , Uu          , Uu          , Cud         , Cud         , Cud         , Cud         , Cud         , Mm^Xm       , Mm^Xm       , Mm^Xm       , Mm^Xm       , Mm^Xm       , Mm^Xm       , Mm^Xm       , Gs          , Gs^Fp       , Gs          , Hh          , Gs          , Ss          , Ss          
Ds          , Ds          , Ds          , Ds          , Ds          , Ds          , Ds          , Dd          , Dd          , Hd          , Md^Xm       , Md^Xm       , Md^Xm       , Re          , Mm^Xm       , Re          , Mm^Xm       , Mm^Xm       , Mm^Xm       , Uu          , Uh          , Uu          , Uu          , Uh          , Uu          , Uu          , Uh          , Uu          , Uu          , Uu          , Uu^Uf       , Uu^Uf       , Mm^Xm       , Mm^Xm       , Mm^Xm       , Mm^Xm       , Mm^Xm       , Mm^Xm       , Mm^Xm       , Mm^Xm       , Mm^Xm       , Mm^Xm       , Mm^Xm       , Mm^Xm       , Mm^Xm       , Mm^Xm       , Gs^Fp       , Gs          , Mm^Xm       , Gs          , Gs          , Mm          , Gs          , Gs          , Re^Uf       , Ss          
Md          , Dd          , Dd          , Gs^Ft       , Ds          , Hd          , Dd^Do       , Ds          , Ds          , Hd          , Md^Xm       , Mm          , Re^Gvs      , Re^Gvs      , Mm^Xm       , Re^Gvs      , Re^Gvs      , Hd          , Mm^Xm       , Uu^Uf       , Uu^Uf       , Uu          , Uu          , Uu^Uf       , Uu          , Uu^Uf       , Uu          , Uu          , Uh          , Uu          , Mm^Xm       , Mm^Xm       , Gs^Fp       , Gs^Ft       , Gs^Fp       , Gs^Ft       , Ss          , Uh^Ii       , Uu          , Uh          , Uh          , Uh          , Mm^Xm       , Uu          , Mm^Xm       , Mm^Xm       , Mm^Xm       , Gs          , Mm^Xm       , Gs^Fp       , Gs          , Gs^Fp       , Gs          , Gs^Fp       , Ss          , Ss          
Md          , Hd          , Dd          , Ds          , Ds          , Ds          , Dd          , Hd          , Ds          , Hd          , Md^Xm       , Md^Xm       , Re^Gvs      , Gg^Efm      , Mm^Xm       , Gg^Efm      , Re^Gvs      , Mm^Xm       , Mm^Xm       , Uu^Uf       , Uu          , Uu^Uf       , Uu          , Uu          , Uu^Ii       , Uu^Ii       , Uu^Ufi      , Uu          , Mm^Xm       , Mm^Xm       , Dd          , Ss          , Gs^Ft       , Mm          , Gs^Ft       , Re^Uf       , Ds          , Uu^Ii       , Uu          , Uh          , Uu          , Uu          , Mm^Xm       , Mm^Xm       , Mm^Xm       , Dd^Dr       , Mm^Xm       , Mm^Xm       , Mm^Xm       , Gs          , Gs          , Gs          , Hh          , Gs          , Gs^Fp       , Ss          
Md          , Dd          , Dd          , Ds          , Hd          , Dd          , Gs^Ft       , Dd          , Ds          , Dd          , Md^Xm       , Mm          , Md^Xm       , Re^Gvs      , Mm^Xm       , Re^Gvs      , Mm^Xm       , Gs^Fp       , Mm^Xm       , Uu          , Uu          , Uu          , Uu          , Uu          , Uu^Ii       , Gs          , Mm^Xm       , Mm^Xm       , Hh          , Ss          , Hh          , Mm          , Gs^Fp       , Ss          , Gs^Fp       , Hh          , Re^Uf       , Uu^Ii       , Uu          , Uu          , Uu^Uf       , Uu^Uf       , Mm^Xm       , Uu          , Mm^Xm       , Mm^Xm       , Gs^Fp       , Gs          , Mm^Xm       , Re^Uf       , Gs          , Gs^Fp       , Mm          , Gs          , Gs^Fp       , Ss          
Dd          , Dd          , Gs^Ft       , Dd          , Dd          , Gs^Ft       , Ds          , Ds          , Dd          , Gs^Ft       , Md^Xm       , Md^Xm       , Gs^Ft       , Gs^Ft       , Mm^Xm       , Gs^Fp       , Gs^Fp       , Mm^Xm       , Mm^Xm       , Uu          , Uh          , Uu          , Uu          , Uh          , Uu^Uf       , Mm^Xm       , Ss          , Ds          , Mm          , Dd          , Ss          , Gs^Ft       , Hh          , Gs^Ft       , Hh          , Ds          , Ss          , Uu^Ii       , Mm^Xm       , Uu          , Mm^Xm       , Uu          , Mm^Xm       , Mm^Xm       , Mm^Xm       , Mm^Xm       , Mm^Xm       , Gs          , Mm^Xm       , Hh          , Gs          , Gs^Fp       , Gs^Fp       , Gs          , Gs^Fp       , Hh          
Dd          , Dd          , Hd          , Dd          , Dd          , Dd          , Md          , Hd          , Ds          , Gs^Ft       , Md^Xm       , Md^Xm       , Md^Xm       , Re          , Mm^Xm       , Re          , Mm^Xm       , Mm^Xm       , Mm^Xm       , Uu^Uf       , Uh          , Uu          , Uu          , Uu          , Uu          , Mm^Xm       , Ds          , Hh          , Dd          , Hh          , Gs^Ft       , Mm          , Gs^Ft       , Ss          , Ds          , Re^Uf       , Mm^Xm       , Mm^Xm       , Rr          , Mm^Xm       , Re          , Mm^Xm       , Rr          , Mm^Xm       , Rp          , Mm^Xm       , Gs          , Mm^Xm       , Mm^Xm       , Gs          , Gs^Fp       , Gs          , Gs          , Gs          , Hh          , Hh          
Ds          , Dd^Do       , Ds          , Dd          , Dd          , Md          , Hd          , Hd          , Ds          , Ds          , Md^Xm       , Ww          , Wwf         , Re          , Ss          , Re          , Gg          , Gs^Fp       , Mm^Xm       , Uu          , Uu          , Uh          , Uu          , Uu          , Uu^Ii       , Mm^Xm       , Gs^Fp       , Mm          , Hh          , Ss          , Re^Uf       , Gs^Fp       , Mm          , Gs^Fp       , Mm^Xm       , Mm^Xm       , Rp          , Rp          , Rr          , Rr          , Rr          , Rr          , Rp          , Rr          , Re          , Gs          , Rp          , Gs          , Mm^Xm       , Gs^Fp       , Gs^Fp       , Gs^Fp       , Gs          , Gs          , Hh          , Hh          
Ds          , Md          , Dd          , Ds          , Dd          , Dd          , Ds          , Hd          , Dd          , Ds          , Md^Xm       , Md^Xm       , Wwf         , Rp          , Ss          , Rp          , Gg          , Mm^Xm       , Mm^Xm       , Uu          , Uh^Ii       , Uu^Ii       , Uu^Ii       , Uh^Ii       , Gg          , Mm^Xm       , Hh          , Dd          , Re^Uf       , Gs^Ft       , Gs^Fp       , Gs^Ft       , Mm^Xm       , Mm^Xm       , Rp          , Rp          , Rp          , Re          , Rr          , Rp          , Rp          , Rp          , Rr          , Rr          , Rp          , Gs          , Gs          , Gs          , Mm^Xm       , Gs          , Gs^Fp       , Gs^Fp       , Gs          , Gs          , Gs          , Ss          
Ds          , Hd          , Ds          , Dd          , Dd          , Dd          , Ds          , Ds          , Ds          , Dd          , Md^Xm       , Ww          , Md^Xm       , Rp          , Md^Xm       , Rp          , Mm^Xm       , Gs^Ft       , Mm^Xm       , Uu^Ufi      , Gg          , Gg          , Gg          , Gg          , Gs^Fp       , Gs          , Gs          , Gg^Wm       , Gs^Fp       , Mm          , Mm^Xm       , Mm^Xm       , Rp          , Rr          , Rr          , Rr          , Rp          , Rr          , Mm^Xm       , Rr          , Mm^Xm       , Rr          , Mm^Xm       , Re          , Mm^Xm       , Gs          , Mm^Xm       , Mm^Xm       , Re^Uf       , Gs          , Gs          , Mm          , Gs          , Gs          , Gs          , Gs^Fp       
Md          , Gs^Ft       , Gs^Ft       , Dd          , Dd          , Hd          , Ds          , Ds          , Ds          , Hd          , Md          , Md^Xm       , Gg          , Gg          , Gg^Wm       , Gg          , Gg          , Mm^Xm       , Ds          , Gg          , Gg          , Dd          , Gg          , Gs          , Gg          , Gg          , Gs^Fp       , Gs          , Mm^Xm       , Mm^Xm       , Rr          , Rp          , Rr          , Rp          , Rr          , Rr          , Mm^Xm       , Mm^Xm       , Re^Uf       , Mm^Xm       , Ss          , Mm^Xm       , Ss          , Mm^Xm       , Hh          , Mm^Xm       , Gs^Fp       , Gs          , Gs          , Gs          , Gs^Fp       , Gs          , Gs^Fp       , Gs^Fp       , Gs^Fp       , Gs^Fp       
Md          , Ds          , Ds          , Dd          , Ds          , Dd          , Dd          , Dd          , Dd          , Dd          , Ds          , Ds          , Dd          , Dd          , Gs^Ft       , Dd          , Gs^Ft       , Gs          , Gg          , Ds          , Gs^Ft       , Gg          , Dd          , Gg          , Gs^Fp       , Gs          , Mm^Xm       , Mm^Xm       , Rp          , Rr          , Rr          , Re          , Rr          , Rp          , Mm^Xm       , Mm^Xm       , Gs          , Gs          , Hh          , Gs^Fp       , Gs          , Gs          , Gs^Fp       , Hh          , Hh          , Gs          , Gs          , Gs          , Gs^Fp       , Gs          , Gs^Fp       , Gs          , Gs^Fp       , Hh          , Gs^Fp       , Gs^Fp       
Md          , Md          , Hd          , Ds          , Hd          , Dd          , Dd          , Ds          , Ds          , Dd          , Dd          , Ds          , Ds          , Ds          , Gg          , Gg          , Ds          , Ds          , Rp          , Gs^Ft       , Ds          , Gs          , Gg          , Gg^Efm      , Gs          , Gg          , Mm^Xm       , Rp          , Rp          , Gg^Wm       , Rp          , Rr          , Mm^Xm       , Mm^Xm       , Gg          , Hh          , Gs          , Gs^Fp       , Gs          , Gs          , Gs          , Gs          , Gs          , Gs^Fp       , Gs          , Gs          , Gs          , Gs^Fp       , Gs          , Gs          , Gs^Fp       , Gs          , Gs          , Gs^Fp       , Gs^Fp       , Mm          
Md          , Dd^Do       , Hd          , Hd          , Gs^Ft       , Gs^Ft       , Dd          , Ds          , Ds          , Hd          , Ds          , Dd          , Dd          , Ds          , Ds          , Gg^Fet      , Dd          , Gg          , Ds          , Dd          , Gs^Ft       , Gg          , Gs^Ft       , Gs          , Gg          , Gg          , Gg^Efm      , Rp          , Re          , Rr          , Re          , Rp          , Mm^Xm       , Gg          , Hh          , Gs          , Gg          , Gs          , Gs          , Gs^Fp       , Gs          , Gs^Fp       , Gs          , Gs          , Gs^Fp       , Gs          , Gs^Fp       , Gs          , Gs          , Gs^Fp       , Hh          , Gs          , Gs          , Gs          , Re^Uf       , Mm          
Ds          , Md          , Dd          , Ds          , Ds          , Gs^Ft       , Ds          , Dd          , Dd          , Dd          , Dd          , Dd          , Ds          , Dd          , Ds          , Gg          , Gg          , Gs^Ft       , Gg          , Ds          , Gg          , Ds          , Gg          , Gs^Ft       , Dd          , Gs          , Gg          , Re          , Gg          , Gg          , Gg          , Re          , Mm^Xm       , Hh          , Gg          , Gg^Efm      , Gg          , Gs          , Gg          , Hh          , Hh          , Gs^Fp       , Gs          , Gs          , Ss          , Gs          , Mm          , Mm          , Mm          , Gs          , Ss          , Gs          , Hh          , Gs          , Re^Uf       , Re^Uf       
Md^Xm       , Ds          , Md^Xm       , Dd          , Md^Xm       , Dd          , Md^Xm       , Hd          , Md^Xm       , Dd          , Md^Xm       , Dd^Do       , Md^Xm       , Ds          , Md^Xm       , Ds          , Md^Xm       , Gg          , Gg^Efm      , Gg          , Dd          , Gs^Ft       , Ds          , Gg          , Gg          , Gg          , Gs          , Gg          , Gg          , Gg^Fet      , Hh          , Gg          , Gg          , Gg          , Hh          , Gg          , Gg          , Gs^Fp       , Gg          , Hh          , Mm^Xm       , Mm^Xm       , Mm^Xm       , Mm^Xm       , Mm^Xm       , Mm^Xm       , Mm^Xm       , Mm^Xm       , Mm^Xm       , Mm^Xm       , Mm^Xm       , Mm^Xm       , Mm^Xm       , Mm^Xm       , Mm^Xm       , Mm^Xm       
Cud         , Md^Xm       , Cud         , Md^Xm       , Cud         , Md^Xm       , Cud         , Md^Xm       , Gg          , Md^Xm       , Gs^Fp       , Md^Xm       , Gs^Fp       , Md^Xm       , Gg          , Md^Xm       , Gg          , Md^Xm       , Gg          , Gg          , Hh          , Gg          , Gg          , Gs^Fp       , Gg          , Gg^Efm      , Hh          , Gg          , Gs^Fp       , Gg          , Gs^Fp       , Gg          , Gg^Efm      , Gg          , Gg          , Gs^Fp       , Gg          , Gg          , Gg          , Gs^Fp       , Hh          , Gg          , Gg^Efm      , Gg          , Gg          , Gg          , Hh          , Gg          , Gg          , Gg          , Gg          , Gg          , Gs^Fp       , Gg          , Gg          , Mm          
Cud         , 7 Kud       , Cud         , Cud         , Cud         , Cud         , Cud         , Cud         , Gg          , Gg          , Gg          , Gs^Fp       , Gg          , Gg          , Gg^Fet      , Gg          , Mm          , Ss          , Gg          , Hh          , Gg          , Gg          , Gg          , Hh          , Gg          , Hh          , Mm          , Gg          , Gg          , Gg          , Gg          , Gg          , Hh          , Gs^Fp       , Gg          , Gs^Fp       , Gs^Fp       , Gg          , Hh          , Gg          , Gs^Fp       , Gg          , Gg          , Mm          , Gs^Ft       , Gg          , Gg          , Gg          , Gg          , Gg          , 3 Kh        , Gg          , Gg          , Gg          , 1 Kh        , Gs^Fp       
Cud         , Cud         , Cud         , Cud         , Cud         , Cud         , Gg          , Gg          , Gg^Efm      , Gs^Fp       , Hh          , Gg^Efm      , Gs^Fp       , Gg          , Hh          , Gg          , Gg^Efm      , Hh          , Gg          , Gg          , Hh          , Gs^Fp       , Gg          , Gg          , Ss          , Hh          , Gg          , Gg          , Gs^Fp       , Hh          , Hh          , Mm          , Gg          , Gg          , Gg          , Gg^Fet      , Gg          , Gs^Fp       , Gg          , Gg          , Gg          , Gg          , Gg          , Gg          , Gg^Efm      , Gg          , Gg^Wm       , Gg^Efm      , Gg          , Gg          , Gg          , Gg          , Rp          , Gg          , Gg          , Gs^Fp       
Cud         , Cud         , Cud         , Cud         , Gs^Fp       , Gg          , Gg^Fet      , Gg          , Gs^Fp       , Gg          , Gg          , Gg          , Gs^Fp       , Gg          , Gg          , Gg          , Gs^Fp       , Hh          , Gs^Fp       , Hh          , Gg          , Gs^Fp       , Mm          , Gs^Fp       , Gg^Efm      , Gg          , Hh          , Gg          , Gg          , Gg          , Gs^Fp       , Gg          , Gg          , Gg          , Gg          , Gg          , Gg          , Gg          , Gg^Efm      , Gg          , Gg          , Gs^Fp       , Gs^Fp       , Hh          , Gs^Fp       , Gs          , Gs^Fp       , Gs          , Gg          , Gg          , 5 Kh        , Gg          , Gg          , Gg          , 2 Kh        , Mm          
Cud         , Cud         , Hh          , Gg          , Gg          , Hh          , Hh          , Gg          , Ss          , Gs^Fp       , Hh          , Gg          , Mm          , Gg          , Gg          , Hh          , Gg          , Gg          , Gg          , Gg          , Hh          , Gg          , Gs^Fp       , Gg          , Gg          , Gg          , Gg          , Gg          , Hh          , Gg          , Gg          , Gs^Fp       , Gg          , Gs^Fp       , Hh          , Hh          , Mm          , Hh          , Gg          , Gs^Fp       , Gg^Efm      , Mm          , Gg          , Gg^Efm      , Gg          , Gs          , Gg          , Gg          , Gg          , Gg          , Gg          , Gg          , 4 Kh        , Gg          , Gg          , Mm          
Hh          , Hh          , Hh          , Hh          , Hh          , Hh          , Gs^Fp       , Gs^Fp       , Gg          , Gs^Fp       , Hh          , Hh          , Gg          , Hh          , Gg          , Gs^Fp       , Gs^Fp       , Gg          , Hh          , Gs          , Gg          , Gg          , Gs^Fp       , Hh          , Gg          , Gs^Fp       , Gg          , Gg          , Gs          , Gg          , Gs^Fp       , Hh          , Gs^Fp       , Gg          , Hh          , Hh          , Hh          , Hh          , Gg          , Gg          , Gg          , Gg          , Gg          , Gg          , Gg          , Hh          , Hh          , Hh          , Mm          , Gs^Fp       , Gg^Fet      , Gs^Fp       , Mm          , Gs^Fp       , Gs^Fp       , Gs^Fp       
