border_size=1
usage=map

Xu          , Xu          , Xu          , Xu          , Xu          , Xu          , Xu          , Xu          , Xu          , Xu          , Xu          , Xu          , Xu          , Xu          , Xu          , Xu          , Xu          , Xu          , Xu          , Xu          , Xu          , Ai          , Ai          , Ai          , Ha          , Ha          , Aa          , Ch          , Ch          , Ch          , Gs          , Gs^Ft       , Gs          , Hh          , Ds          , Ds          , Ds          , Ds          , Ds          , Hd          , Hd          , Md          
Xu          , Xu          , Xu          , Xu          , Xu          , Xu          , Xu          , Xu          , Xu          , Xu          , Xu          , Xu          , Xu          , Xu          , Xu          , Xu          , Xu          , Xu          , Xu          , Xu          , Xu          , Ai          , Ai          , Ai          , Ha          , Ha          , Aa          , Ch          , Ch          , Ch          , Gs          , Gs^Ft       , Gs          , Hh          , Ds          , Ds          , Ds          , Ds          , Ds          , Ds          , Ds          , Hd          
Xu          , Xu          , Ww          , Gg          , Rr          , Xu          , Gs^Fp       , Hh          , Ch          , Ch          , Ch          , Gs^Fp       , Hh          , Gs^Fp       , Gs^Fp       , Xu          , Gs          , Gs^Ft       , Gs^Ft       , Gs^Ft       , Xu          , Ai          , Ha          , Ha          , Aa^Fpa      , Aa          , Ch          , Ch          , 8 Kh        , Ch          , Gs          , Gs          , Gs          , Gs          , Chr         , Ds          , Ds          , Ds          , Re          , Ds          , Ds          , Ds          
Xu          , Xu          , Ww          , Ww          , Rr          , Xu          , Mm          , Gg          , Ch          , 6 Kh        , Ch          , Gg          , Gg          , Hh          , Gs^Fp       , Xu          , Hh          , Gs          , Gs^Ft       , Gs^Ft       , Xu          , Ha          , Ha          , Ha          , Rd          , Rd          , Ch          , Ch          , Ch          , Ch          , Gs          , Gs          , Gs          , Ds          , Ds          , Ds          , Ds          , Ds          , Ds          , Ds          , Ds          , Ds          
Xu          , Xu          , Ww          , Xu          , Rr          , Xu          , Hh          , Mm          , Gg          , Ch          , Xu          , Gs^Fp       , Gs^Fp       , Gs^Fp       , Gs^Fp       , Gg          , Gs          , Hh          , Ss          , Gs^Ft       , Xu          , Aa^Fpa      , Aa^Fpa      , Rd          , Ha          , Aa          , Aa          , Ch          , Xu          , Ch          , Gs^Ft       , Gs          , Gs^Ft       , Ds          , Ds          , Ds          , Ds          , Ds          , Ds          , Chr         , Ds          , Ds          
Xu          , Xu          , Ww          , Ww          , Rr          , Xu          , Gg          , Gg          , Hh          , Gs^Fp       , Xu          , Gs^Fp       , Gg          , Gs^Fp       , Hh          , Gs^Fp       , Gs^Ft       , Gs          , Gs^Ft       , Gs^Ft       , Xu          , Ha          , Ha          , Rd          , Ha          , Aa^Fpa      , Aa          , Ch          , Xu          , Ch          , Mm          , Hh          , Hh          , Mm          , Ss          , Ds          , Wwf         , Ds          , Ww          , Ds          , Ds          , Ds          
Xu          , Xu          , Rr          , Rr          , Xu          , Xu          , Mm          , Gg          , Gg          , Mm          , Xu          , Gs^Fp       , Gs^Fp       , Gg          , Hh          , Xu          , Gs^Ft       , Gs^Ft       , Gs^Ft       , Hh          , Xu          , Ha          , Aa          , Rd          , Aa^Fpa      , Xu          , Xu          , Ch          , Xu          , Xu          , Xu          , Xu          , Ss          , Ss          , Chs         , Ss          , Wwf         , Ss          , Ww          , Ss          , Ss          , Ss          
Xu          , Xu          , Rr          , Xu          , Rr          , Gs^Fp       , Gg          , Hh          , Gg          , Gg          , Xu          , Hh          , Gs^Fp       , Gg          , Gs^Fp       , Xu          , Hh          , Ss          , Gs          , Gs          , Xu          , Aa          , Aa          , Rd          , Aa^Fpa      , Aa^Fpa      , Aa^Fpa      , Xu          , Gs          , Ss          , Ss          , Xu          , Ss          , Ss          , Ss          , Ss          , Wwf         , Chw         , Ww          , Ww          , Ss          , Ss          
Xu          , Xu          , Ww          , Rr          , Ww          , Rr          , Rr          , Gg          , Ds          , Ds          , Xu          , Hh          , Gs^Fp       , Gs^Fp       , Gg          , Xu          , Gs^Ft       , Gs^Ft       , Gs^Ft       , Gs^Ft       , Xu          , Aa^Fpa      , Aa^Fpa      , Rd          , Rd          , Ha          , Aa^Fpa      , Xu          , Xu          , Gs          , Gs          , Xu          , Xu          , Ss          , Ww          , Ss          , Wwf         , Ww          , Ww          , Ww          , Ss          , Ss          
Xu          , Xu          , Ww          , Ww          , Ww          , Wwf         , Wwf         , Ds          , Ww          , Ww          , Xu          , Gg          , Gg          , Gg          , Gg          , Gg          , Hh          , Hh          , Mm          , Mm          , Xu          , Xu          , Xu          , Aa^Fpa      , Rd          , Rd          , Uu^Uf       , Uu          , Xu          , Ss          , Ss          , Gs          , Xu          , Ww          , Ww          , Ww          , Wwf         , Ww          , Ss          , Chs         , Ss          , Ss          
Xu          , Xu          , Ww          , Ww          , Ce          , Wwf         , Wwf         , Ww          , Ww          , Ww          , Xu          , Gg          , Gg          , Gg          , Gg          , Gg          , Hh          , Mm          , Mm          , Mm          , Xu          , Aa^Fpa      , Rd          , Rd          , Aa^Fpa      , Rd          , Uu^Uf       , Uh          , Xu          , Ss          , Ss          , Gs          , Ss          , Xu          , Xu          , Ww          , Wwf         , Chw         , Ss          , Ss          , Gs          , Gs          
Xu          , Xu          , Ww          , Ww          , Ce          , Wwf         , Wwf         , Ce          , Ww          , Ww          , Xu          , Gg          , Hh          , Gs^Fp       , Gg          , Hh          , Mm          , Mm          , Mm          , Mm          , Xu          , Ha          , Rd          , Xu          , Aa^Fpa      , Rd          , Uh          , Uu          , Xu          , Chs         , Ss          , Gs          , Ss          , Chs         , Xu          , Ww          , Wwf         , Ww          , Hh          , Ss          , Gs          , Gs          
Xu          , Xu          , Ww          , Ww          , Ww          , Wwf         , Wwf         , Ce          , Ww          , Ww          , Xu          , Hh          , Mm          , Hh          , Gg          , Gs^Fp       , Gs^Fp       , Mm          , Hh          , Mm          , Xu          , Aa          , Rd          , Xu          , Ha          , Rd          , Rd          , Uu^Uf       , Uh          , Xu          , Xu          , Gs          , Ss          , Ss          , Xu          , Ww          , Wwf         , Ww          , Mm          , Gs^Ft       , Gs          , Gs          
Xu          , Xu          , Ww          , Ww          , Ww          , Wwf         , Wwf         , Ww          , Ww          , Ww          , Xu          , Mm          , Mm          , Mm          , Xu          , Gg          , Hh          , Hh          , Hh          , Hh          , Xu          , Aa^Fpa      , Aa          , Xu          , Ha          , Ha          , Rd          , Uu^Uf       , Uu          , Uu^Uf       , Xu          , Gs          , Xu          , Xu          , Gs          , Gs^Ft       , Gs          , Gs          , Gs          , Gs          , Gs^Ft       , Gs^Ft       
Xu          , Xu          , Gs^Fp       , Ww          , Mm          , Wwf         , Wwf         , Ww          , Ww          , Ww          , Xu          , Mm          , Mm          , Mm          , Xu          , Gg          , Gg          , Gg          , Gg          , Gs^Fp       , Xu          , Aa          , Rd          , Xu          , Aa^Fpa      , Aa^Fpa      , Rd          , Ha          , Aa          , Aa          , Xu          , Gs          , Gs          , Gs          , Xu          , Gs          , Gs          , Hh          , Gs          , Gs          , Hh          , Hh          
Xu          , Xu          , Gg          , Hh          , Gs^Fp       , Ds          , Ds          , Mm          , Gs^Fp       , Gs^Fp       , Xu          , Xu          , Xu          , Gg          , Xu          , Gs^Fp       , Gg          , Gg          , Gg          , Gg          , Xu          , Xu          , Xu          , Xu          , Aa^Fpa      , Aa^Fpa      , Rd          , Ha          , Aa          , Aa          , Xu          , Ql          , Ql          , Ql          , Xu          , Hh          , Gs^Ft       , Gs          , Gs          , Gs^Ft       , Hh          , Hh          
Xu          , Xu          , Gg          , Gg          , Gg          , Gg          , Gg          , Gg          , Gg          , Hh          , Xu          , Xu          , Xu          , Xu          , Xu          , Gg          , Gg          , Gg          , Gg          , Hh          , Ch          , Xu          , Ha          , Ha          , Aa^Fpa      , Aa^Fpa      , Rd          , Aa^Fpa      , Aa^Fpa      , Aa^Fpa      , Xu          , Ql          , Ql          , Ql          , Xu          , Mm          , Ch          , Gs          , Ch          , Hh          , Ch          , Ch          
Xu          , Xu          , Gs^Fp       , Gg          , 5 Kh        , Gg          , Gg          , 4 Kh        , Gg          , Gg          , Xu          , Xu          , Xu          , Xu          , Xu          , Xu          , Xu          , Gg          , Gg          , Ch          , Ch          , Ch          , Ch          , Aa          , Rd          , Rd          , Ha          , Aa^Fpa      , Aa^Fpa      , Aa^Fpa      , Xu          , Ql          , Ql          , Ql          , Xu          , Ch          , Ch          , Ch          , Ch          , Ch          , Ch          , Ch          
Xu          , Xu          , Hh          , Gg          , Gg          , Gg          , Gg          , Gg          , 3 Kh        , Gs^Fp       , Xu          , Xu          , Xu          , Xu          , Xu          , Xu          , Xu          , Xu          , Hh          , Ch          , Ch          , 7 Kh        , Ch          , Rd          , Aa^Fpa      , Aa^Fpa      , Aa^Fpa      , Aa^Fpa      , Aa^Fpa      , Aa^Fpa      , Xu          , Ql          , Ql          , Ql          , Xu          , Ch          , Ch          , Ch          , 9 Kh        , Ch          , Ch          , Ch          
Xu          , Xu          , Gg          , 1 Kh        , Gg          , Gg          , Gg          , Gg          , Gg          , Gg          , Xu          , Xu          , Xu          , Xu          , Xu          , Xu          , Xu          , Xu          , Mm          , Ch          , Mm          , Ch          , Ms          , Aa          , Aa^Fpa      , Aa^Fpa      , Aa^Fpa      , Aa^Fpa      , Ha          , Ha          , Xu          , Ql          , Ql          , Ql          , Xu          , Ch          , Ch          , Ch          , Ch          , Ch          , Ch          , Ch          
Xu          , Xu          , Gs^Fp       , Gg          , Gg          , 2 Kh        , Gg          , Hh          , Gs^Fp       , Gs^Fp       , Xu          , Xu          , Xu          , Xu          , Xu          , Xu          , Xu          , Xu          , Xu          , Xu          , Xu          , Xu          , Xu          , Xu          , Xu          , Xu          , Xu          , Xu          , Xu          , Xu          , Xu          , Xu          , Xu          , Xu          , Xu          , Ch          , Ch          , Ch          , Ch          , Ch          , Ch          , Ch          
Xu          , Xu          , Gs^Fp       , Gg          , Gg          , Ch          , Gg          , Hh          , Gs^Fp       , Gs^Fp       , Xu          , Xu          , Xu          , Xu          , Xu          , Xu          , Xu          , Xu          , Xu          , Xu          , Xu          , Xu          , Xu          , Xu          , Xu          , Xu          , Xu          , Xu          , Xu          , Xu          , Xu          , Xu          , Xu          , Xu          , Xu          , Ch          , Ch          , Ch          , Ch          , Ch          , Ch          , Ch          
