border_size=1
usage=map

Xu          , Xu          , Xu          , Xu          , Xu          , Xu          , Xu          , Xu          , Xu          , Xu          , Xu          , Xu          , Xu          , Xu          , Xu          , Xu          , Xu          , Xu          , Wo          , Xu          , Xu          , Xu          , Xu          , Xu          , Xu          , Xu          , Xu          , Xu          , Xu          , Xu          , Xu          , Xu          
Xu          , Xu          , Xu          , Xu          , Xu          , Xu          , Xu          , Xu          , Xu          , Xu          , Xu          , Xu          , Xu          , Xu          , Xu          , Xu          , Xu          , Xu          , Wo          , Xu          , Xu          , Xu          , Xu          , Xu          , Xu          , Xu          , Xu          , Xu          , Xu          , Xu          , Xu          , Xu          
Xu          , Xu          , Xu          , Xu          , Xu          , Xu          , Xu          , Xu          , Xu          , Xu          , Xu          , Wo          , Xu          , Xu          , Xu          , Xu          , Xu          , Xu          , Xu          , Xu          , Xu          , Xu          , Xu          , Xu          , Xu          , Xu          , Xu          , Xu          , Xu          , Xu          , Xu          , Xu          
Xu          , Xu          , Xu          , Xu          , Xu          , Xu          , Xu          , Xu          , Xu          , Xu          , Xu          , Xu          , Xu          , Xu          , Xu          , Xu          , Xu          , Xu          , Xu          , Xu          , Xu          , Xu          , Xu          , Xu          , Xu          , Xu          , Xu          , Xu          , Xu          , Xu          , Xu          , Xu          
Xu          , Xu          , Xu          , Xu          , Xu          , Xu          , Xu          , Xu          , Xu          , Xu          , Xu          , Wo          , Wo          , Xu          , Wo          , Xu          , Wo          , Xu          , Wo          , Wo          , Xu          , Xu          , Xu          , Xu          , Xu          , Xu          , Xu          , Xu          , Xu          , Xu          , Xu          , Xu          
Xu          , Xu          , Xu          , Xu          , Xu          , Xu          , Xu          , Xu          , Xu          , Xu          , Xu          , Xu          , Xu          , Wo          , Xu          , Wo          , Xu          , Wo          , Xu          , Xu          , Xu          , Xu          , Xu          , Xu          , Xu          , Xu          , Xu          , Xu          , Ce          , Ce          , Ce          , Ce          
Xu          , Xu          , Ce          , Ce          , Ce          , Xu          , Xu          , Xu          , Xu          , Xu          , Xu          , Xu          , Xu          , Xu          , Xu          , Xu          , Xu          , Xu          , Xu          , Xu          , Xu          , Xu          , Xu          , Xu          , Xu          , Xu          , Xu          , Ce          , Ce          , Ce          , Ce          , Ce          
Ce          , Ce          , Ce          , Ce          , Ce          , Ce          , Xu          , Xu          , Xu          , Xu          , Xu          , Xu          , Xu          , Xu          , Ww^Bw|      , Xu          , Xu          , Ww^Bw|      , Xu          , Xu          , Xu          , Xu          , Xu          , Xu          , Uh          , Uh          , Gg          , Ce          , Ce          , 7 Ke        , Ce          , Ce          
Ce          , Ce          , Ce          , 8 Ke        , Ce          , Ce          , Uh          , Xu          , Xu          , Xu          , Xu          , Xu          , Xu          , Xu          , Ww^Bw|      , Xu          , Xu          , Ww^Bw|      , Xu          , Xu          , Xu          , Xu          , Xu          , Uh          , Gg          , Gg          , Gg          , Ce          , Ce          , Ce          , Ce          , Ce          
Ce          , Ce          , Ce          , Ce          , Ce          , Ce          , Wwf         , Uh          , Xu          , Xu          , Wwf         , Xu          , Wwf         , Xu          , Wwf         , Xu          , Wwf         , Rr          , Rr          , Xu          , Rr          , Xu          , Xu          , Xu          , Gg          , Gg          , Gg          , Gg          , Xu          , Ce          , Xu          , Xu          
Xu          , Xu          , Xu          , Ce          , Wwf         , Wwf         , Chw         , Wwf         , Wwf         , Wwf         , Xu          , Wwf         , Rr          , Wwf         , Xu          , Wwf         , Xu          , Rr          , Xu          , Rr          , Xu          , Rr          , Gg          , Gg          , Chs         , Gg          , Gg          , Gg          , Xu          , Xu          , Xu          , Xu          
Xu          , Xu          , Xu          , Uh          , Uh          , Wwf         , Wwf         , Wwf         , Wwf         , Xu          , Xu          , Xu          , Xu          , Rr          , Gs^Fp       , Xu          , Ss          , Rr          , Xu          , Xu          , Xu          , Xu          , Gg          , Gg          , Gg          , Gg          , Uh          , Uh          , Xu          , Xu          , Xu          , Xu          
Xu          , Xu          , Xu          , Xu          , Xu          , Xu          , Rr          , Wwf         , Ww^Bw\      , Uu          , Uu          , Ss          , Ss          , Hh          , Dd          , Gg          , Dd          , Dd          , Gg          , Ss          , Md          , Gg          , Gg          , Gg          , Xu          , Xu          , Xu          , Xu          , Xu          , Xu          , Xu          , Xu          
Xu          , Xu          , Xu          , Xu          , Xu          , Xu          , Rr          , Xu          , Uh          , Ww^Bw\      , Ww^Bw\      , Wwf         , Wwf         , Gg          , Qxu         , Qxu         , Qxu         , Gg          , Gg          , Gs^Fp       , Hh          , Gg          , Xu          , Rr          , Xu          , Xu          , Xu          , Xu          , Xu          , Xu          , Xu          , Xu          
Xu          , Xu          , Xu          , Xu          , Ww^Bw\      , Xu          , Rr          , Xu          , Uh          , Gg          , Wwf         , Hh          , Rr          , Qxu         , Cud         , Cud         , Cud         , Qxu         , Rr          , Gg          , Gg          , Gg          , Xu          , Rr          , Ww^Bw/      , Ww^Bw/      , Xu          , Xu          , Xu          , Xu          , Xu          , Xu          
Xu          , Xu          , Xu          , Xu          , Xu          , Ww^Bw\      , Rr          , Xu          , Gs^Fp       , Md          , Wwf         , Rr          , Cud         , 3 Kud       , Gs^Fp       , Wwf         , Gs^Fp       , 4 Kud       , Cud         , Rr          , Gg          , Gs^Fp       , Xu          , Rr          , Xu          , Xu          , Xu          , Xu          , Xu          , Xu          , Xu          , Xu          
Xu          , Xu          , Xu          , Xu          , Xu          , Xu          , Rr          , Rr          , Ds          , Hh          , Gg          , Qxu         , Cud         , Dd^Do       , Ai          , Ss          , Ai          , Dd^Do       , Cud         , Qxu         , Gg          , Ds          , Rr          , Rr          , Xu          , Xu          , Xu          , Xu          , Xu          , Xu          , Xu          , Xu          
Xu          , Xu          , Xu          , Xu          , Ww^Bw\      , Xu          , Rr          , Rr          , Ds          , Ds          , Gg          , Qxu         , Cud         , Gs^Fp       , Ai          , Wwf         , Ai          , Gs^Fp       , Cud         , Qxu         , Gg          , Ds          , Rr          , Rr          , Ww^Bw/      , Ww^Bw/      , Xu          , Xu          , Xu          , Xu          , Xu          , Xu          
Xu          , Xu          , Xu          , Xu          , Xu          , Ww^Bw\      , Rr          , Xu          , Uu          , Ss          , Gg          , Qxu         , 2 Kud       , Gs^Fp       , Dd^Do       , Ss          , Gs^Fp       , Wwf         , 5 Kud       , Qxu         , Gg          , Hh          , Xu          , Rr          , Xu          , Xu          , Xu          , Xu          , Xu          , Xu          , Xu          , Xu          
Xu          , Xu          , Xu          , Xu          , Ww^Bw\      , Xu          , Rr          , Xu          , Uu          , Hh          , Gg          , Rr          , Rr          , Cud         , Cud         , Wwf         , Cud         , Cud         , Rr          , Rr          , Gg          , Uh          , Xu          , Rr          , Ww^Bw/      , Ww^Bw/      , Xu          , Xu          , Xu          , Xu          , Xu          , Xu          
Xu          , Xu          , Xu          , Xu          , Xu          , Ww^Bw\      , Rr          , Xu          , Uu          , Gs^Fp       , Gs^Fp       , Gg          , Hh          , Qxu         , Qxu         , 1 Kud       , Qxu         , Qxu         , Gg          , Hh          , Gg          , Ss          , Xu          , Rr          , Xu          , Xu          , Xu          , Xu          , Xu          , Xu          , Xu          , Xu          
Xu          , Xu          , Xu          , Xu          , Xu          , Xu          , Rr          , Xu          , Uu          , Uu          , Wwf         , Gg          , Gg          , Gg          , Dd          , Qxu         , Dd          , Gg          , Gg          , Gg          , Gs^Fp       , Re          , Re          , Rr          , Re          , Xu          , Xu          , Xu          , Ce          , Xu          , Xu          , Xu          
Xu          , Xu          , Xu          , Xu          , Uh          , Xu          , Gs^Fp       , Gs^Fp       , Gs^Fp       , Wwf         , Xu          , Md          , Xu          , Ss          , Dd          , Hh          , Dd          , Gg          , Xu          , Md          , Xu          , Re          , Re          , Re          , Chs         , Re          , Ce          , Ce          , Ce          , Ce          , Ce          , Ce          
Xu          , Xu          , Xu          , Uh          , Gs^Fp       , Gs^Fp       , Chs         , Gs^Fp       , Gs^Fp       , Xu          , Rr          , Xu          , Rr          , Xu          , Rr          , Rr          , Rr          , Xu          , Rr          , Xu          , Rr          , Re          , Re          , Re          , Re          , Re          , Ce          , Ce          , 6 Ke        , Ce          , Ce          , Ce          
Xu          , Xu          , Ce          , Ce          , Ce          , Gs^Fp       , Gs^Fp       , Gs^Fp       , Xu          , Rr          , Xu          , Rr          , Xu          , Rr          , Xu          , Gs^Fp       , Xu          , Rr          , Xu          , Rr          , Uh          , Uh          , Xu          , Re          , Xu          , Re          , Ce          , Ce          , Ce          , Ce          , Ce          , Ce          
Ce          , Ce          , Ce          , Ce          , Ce          , Ce          , Uh          , Uh          , Xu          , Xu          , Xu          , Xu          , Xu          , Ww^Bw|      , Xu          , Xu          , Xu          , Ww^Bw|      , Xu          , Xu          , Xu          , Xu          , Xu          , Xu          , Xu          , Xu          , Xu          , Ce          , Ce          , Ce          , Xu          , Xu          
Ce          , Ce          , Ce          , 9 Ke        , Ce          , Ce          , Xu          , Xu          , Xu          , Xu          , Xu          , Xu          , Xu          , Ww^Bw|      , Xu          , Xu          , Xu          , Ww^Bw|      , Xu          , Xu          , Xu          , Xu          , Xu          , Xu          , Xu          , Xu          , Xu          , Xu          , Xu          , Xu          , Xu          , Xu          
Ce          , Ce          , Ce          , Ce          , Ce          , Ce          , Xu          , Xu          , Xu          , Xu          , Xu          , Xu          , Xu          , Xu          , Xu          , Xu          , Xu          , Xu          , Xu          , Xu          , Xu          , Xu          , Xu          , Xu          , Xu          , Xu          , Xu          , Xu          , Xu          , Xu          , Xu          , Xu          
Xu          , Xu          , Xu          , Ce          , Xu          , Xu          , Xu          , Xu          , Xu          , Xu          , Xu          , Ql          , Xu          , Xu          , Xu          , Ql          , Xu          , Xu          , Xu          , Xu          , Xu          , Xu          , Xu          , Xu          , Xu          , Xu          , Xu          , Xu          , Xu          , Xu          , Xu          , Xu          
Xu          , Xu          , Xu          , Xu          , Xu          , Xu          , Xu          , Xu          , Xu          , Xu          , Xu          , Xu          , Ql          , Xu          , Ql          , Xu          , Xu          , Xu          , Xu          , Xu          , Xu          , Xu          , Xu          , Xu          , Xu          , Xu          , Xu          , Xu          , Xu          , Xu          , Xu          , Xu          
Xu          , Xu          , Xu          , Xu          , Xu          , Xu          , Xu          , Xu          , Xu          , Xu          , Ql          , Ql          , Xu          , Ql          , Xu          , Ql          , Ql          , Xu          , Xu          , Xu          , Xu          , Xu          , Xu          , Xu          , Xu          , Xu          , Xu          , Xu          , Xu          , Xu          , Xu          , Xu          
Xu          , Xu          , Xu          , Xu          , Xu          , Xu          , Xu          , Xu          , Xu          , Xu          , Ql          , Ql          , Xu          , Ql          , Xu          , Ql          , Ql          , Xu          , Xu          , Xu          , Xu          , Xu          , Xu          , Xu          , Xu          , Xu          , Xu          , Xu          , Xu          , Xu          , Xu          , Xu          
