border_size=1
usage=map

Qxu         , Qxu         , Qxu         , Qxu         , Qxu         , Qxu         , Qxu         , Qxu         , Qxu         , Qxu         , Qxu         , Qxu         , Qxu         , Qxu         , Qxu         , Qxu         , Qxu         , Qxu         , Qxu         , Qxu         , Qxu         , Qxu         , Qxu         , Qxu         , Qxu         , Qxu         , Qxu         , Qxu         , Qxu         , Qxu         , Qxu         , Qxu         , Qxu         , Qxu         , Qxu         , Qxu         , Qxu         
Qxu         , Qxu         , Qxu         , Qxu         , Qxu         , Qxu         , Qxu         , Qxu         , Qxu         , Qxu         , Qxu         , Qxu         , Qxu         , Qxu         , Qxu         , Qxu         , Qxu         , Qxu         , Qxu         , Qxu         , Qxu         , Qxu         , Qxu         , Qxu         , Qxu         , Qxu         , Qxu         , Qxu         , Qxu         , Qxu         , Qxu         , Qxu         , Qxu         , Qxu         , Qxu         , Qxu         , Qxu         
Qxu         , Qxu         , Xu          , Xu          , Xu          , Xu          , Xu          , Xu          , Xu          , Xu          , Xu          , Xu          , Xu          , Xu          , Xu          , Xu          , Xu          , Xu          , Xu          , Xu          , Xu          , Xu          , Xu          , Xu          , Xu          , Xu          , Xu          , Xu          , Xu          , Xu          , Xu          , Xu          , Xu          , Xu          , Xu          , Qxu         , Qxu         
Qxu         , Qxu         , Xu          , Ha          , Ha          , Ha          , Ha          , Ha          , Ha          , Ha          , Xu          , Xu          , Wo          , Wo          , Wo          , Wo          , Wo          , Wo          , Wo          , Xu          , Xu          , Xu          , Chs         , Xu          , Xu          , Xu          , Uu^Uf       , Xu          , Xu          , Xu          , Rd          , Rd          , Rd          , Xu          , Xu          , Qxu         , Qxu         
Qxu         , Qxu         , Xu          , Ha          , Aa^Fpa      , Aa^Fpa      , Aa^Fpa      , Aa^Fpa      , Aa^Fpa      , Ha          , Xu          , Xu          , Ww          , Ww          , Ww          , Ww          , Ww          , Ww          , Ww          , Xu          , Xu          , Chs         , Chs         , Chs         , Xu          , Uu^Uf       , Uu          , Uu          , Xu          , Rd          , Chr         , Chr         , Chr         , Rd          , Xu          , Qxu         , Qxu         
Qxu         , Qxu         , Xu          , Ha          , Aa^Fpa      , Aa          , Aa          , Aa          , Aa^Fpa      , Ha          , Xu          , Xu          , Ww          , Ww          , Ww          , Ww          , Ww          , Ww          , Ww          , Xu          , Xu          , Chs         , Chs         , Chs         , Xu          , Uu^Uf       , Uu          , Uu^Uf       , Xu          , Rd          , Chr         , 8 Kh        , Chr         , Rd          , Xu          , Qxu         , Qxu         
Qxu         , Qxu         , Xu          , Ha          , Aa^Fpa      , Aa          , Rr          , Aa          , Aa^Fpa      , Ha          , Ha          , Xu          , Wwf         , Ww          , Wwf         , Ww          , Wwf         , Ww          , Wwf         , Xu          , Xu          , Ss          , Ss          , Ss          , Xu          , Uu^Uf       , Uu          , Uu^Uf       , Cud         , Rd          , Rd          , Chr         , Rd          , Rd          , Xu          , Qxu         , Qxu         
Qxu         , Qxu         , Xu          , Ha          , Aa^Fpa      , Aa          , Rr          , Aa          , Aa          , Aa^Fpa      , Hh          , Hh          , Gg          , Wwf         , Chr         , Wwf         , Chr         , Wwf         , Hh          , Xu          , Xu          , Ss          , Ss          , Ss          , Uu^Uf       , Uu^Uf       , Rr          , Rr          , Uh          , Xu          , Xu          , Rd          , Xu          , Xu          , Xu          , Qxu         , Qxu         
Qxu         , Qxu         , Xu          , Ha          , Aa^Fpa      , Aa          , Rr          , Aa          , Hh          , Gg          , Gg          , Gg          , Gg          , Gg          , Gg          , 7 Kh        , Gg          , Gg          , Mm          , Xu          , Xu          , Ss          , Uu^Uf       , Uu^Uf       , Rr          , Rr          , Uu          , Uu          , Uu          , Uh          , Uh          , Xu          , Uh          , Uh          , Xu          , Qxu         , Qxu         
Qxu         , Qxu         , Xu          , Ha          , Aa^Fpa      , Rr          , Hh          , Mm          , Gg          , Gg          , Gs^Fp       , Gg          , Gg          , Gg          , Gg          , Chr         , Gg          , Gs^Fp       , Hh          , Xu          , Xu          , Uu^Uf       , Uu          , Rr          , Rr          , Uu          , Xu          , Uh          , Uh          , Uu          , Uu          , Uh          , Uu          , Uh          , Xu          , Qxu         , Qxu         
Qxu         , Qxu         , Xu          , Ha          , Hh          , Gg          , Gg          , Gg          , Gs^Fp       , Gs^Fp       , Hh          , Gs^Fp       , Hh          , Gg          , Gg          , Gg          , Gg          , Gs^Fp       , Mm          , Xu          , Xu          , Uu          , Uu          , Rr          , Ww          , Wwf         , Wwf         , Xu          , Xu          , Uh          , Uh          , Uu          , Uh          , Uh          , Xu          , Qxu         , Qxu         
Qxu         , Qxu         , Xu          , Hh          , Gs^Fp       , Gg          , Gg          , Gg          , Gs^Fp       , Hh          , Hh          , Mm          , Xu          , Xu          , Gg          , Gg          , Gg          , Gg          , Hh          , Xu          , Xu          , Xu          , Xu          , Wwf         , Wwf         , Ww          , Ww          , Wwf         , Wwf         , Xu          , Xu          , Uh          , Xu          , Xu          , Xu          , Qxu         , Qxu         
Qxu         , Qxu         , Xu          , Gs^Fp       , Hh          , 1 Kh        , Gs^Fp       , Gg          , Hh          , Mm          , Xu          , Xu          , Mm          , Hh          , Gg          , Gg          , Gg          , Gg          , Gs^Fp       , Mm          , Hh          , Xu          , Xu          , Xu          , Xu          , Wwf         , Wwf         , Ww          , Ww          , Wwf         , Wwf         , Xu          , Xu          , Xu          , Xu          , Qxu         , Qxu         
Qxu         , Qxu         , Xu          , Hh          , Mm          , Hh          , Gs^Fp       , Gg          , Xu          , Xu          , Gs^Fp       , Hh          , Hh          , Hh          , Gg          , Gg          , Gg          , Gg          , Gg          , Gs^Fp       , Gg          , Gg          , Gg          , Xu          , Xu          , Xu          , Xu          , Wwf         , Wwf         , Ww          , Ww          , Wwf         , Wwf         , Xu          , Xu          , Qxu         , Qxu         
Qxu         , Qxu         , Xu          , Ss          , Ss          , Hh          , Gs          , Gs          , Gs^Ft       , Gs^Fp       , Gs^Fp       , Gs^Fp       , Gg          , Gg          , Gg          , Gg          , Gs^Fp       , Gg          , Gg          , Gg          , Gg          , Gg          , Xu          , Ss^Bw\r     , Ss^Bw\r     , Xu          , Xu          , Xu          , Xu          , Wwf         , Wwf         , Ww          , Ww          , Wwf         , Xu          , Qxu         , Qxu         
Qxu         , Qxu         , Xu          , Ss          , Xu          , Xu          , Gs          , Gs^Ft       , Gs          , Gs^Ft       , Gs          , Gg          , Gg          , Gg          , Gs^Fp       , Gs^Fp       , Gg          , Gg          , Mm          , Hh          , Xu          , Xu          , Xu          , Xu          , Ss          , Ss^Bw\r     , Ss^Bw\r     , Xu          , Xu          , Xu          , Xu          , Wwf         , Ds          , Ds          , Xu          , Qxu         , Qxu         
Qxu         , Qxu         , Xu          , Xu          , Gs^Ft       , Gs          , Gs          , Gs          , Gs          , Gs          , Gs^Ft       , Gs          , Gg          , Gg          , Gg          , Gg          , Mm          , 4 Kh        , Ss^Bw\r     , Xu          , Xu          , Xu          , Ss          , Ss          , Ss          , Ss          , Ss          , Ss^Bw\r     , Ss^Bw\r     , Xu          , Ds          , Ds          , Chr         , Chr         , Xu          , Qxu         , Qxu         
Qxu         , Qxu         , Xu          , Gs^Ft       , Gs          , Gs          , Chr         , Xu          , Xu          , Gs          , Gs^Ft       , Gs^Ft       , Gs^Fp       , Gg          , Gg          , Hh          , Xu          , Ss          , Ss          , Ss^Bw\r     , Ss^Bw\r     , Ss          , Chs         , Ss          , Ss          , Ss          , Ss          , Ss          , Ss          , Ss^Bw\r     , Ds          , Chr         , Ds          , Ds          , Xu          , Qxu         , Qxu         
Qxu         , Qxu         , Xu          , Chr         , Chr         , Gs          , Gs          , Chr         , Xu          , Gs          , 3 Kh        , Gs^Ft       , Gs^Fp       , Gg          , Gg          , Xu          , Xu          , Xu          , Ss          , Ss          , Ss^Bw/r     , Chs         , Chs         , Chs         , Ss          , Ss          , Ss          , Ss          , Ss          , Ss          , Ds          , Chr         , Ds          , Chr         , Xu          , Qxu         , Qxu         
Qxu         , Qxu         , Xu          , Chr         , Gs          , Gs          , Chr         , Chr         , Xu          , Gs          , Gs^Ft       , Gs^Ft       , Gs^Fp       , Gg          , Gg          , Hh          , Mm          , Ss          , Ss^Bw/r     , Ss^Bw/r     , Xu          , Ss          , Ss          , Ss          , Ss          , Ss          , Ss          , Ss          , Ss^Bw/r     , Ss^Bw/r     , Ds          , Chr         , Chr         , Ds          , Xu          , Qxu         , Qxu         
Qxu         , Qxu         , Xu          , Gs^Ft       , Gs^Ft       , Gs          , Gs          , Xu          , Gs          , Gs          , Gs^Ft       , Gs^Ft       , Gg          , Gg          , Gg          , Gg          , Gg          , 5 Kh        , Mm          , Xu          , Xu          , Xu          , Xu          , Ss          , Ss          , Ss          , Ss^Bw/r     , Ss^Bw/r     , Xu          , Xu          , Xu          , Ds          , Ds          , Chr         , Xu          , Qxu         , Qxu         
Qxu         , Qxu         , Xu          , Xu          , Xu          , Gs          , Gs          , Gs          , Gs          , Gs          , Gs          , Gs          , Gg          , Gg          , Gs^Fp       , Gg          , Gg          , Gg          , Gg          , Hh          , Gg          , Xu          , Xu          , Xu          , Ss^Bw/r     , Ss^Bw/r     , Xu          , Xu          , Xu          , Xu          , Wwf         , Wwf         , Ww          , Ds          , Xu          , Qxu         , Qxu         
Qxu         , Qxu         , Xu          , Ss          , Ss          , Xu          , Gs          , Gs^Ft       , Gs^Ft       , Gs^Ft       , Gs^Fp       , Gg          , Gg          , Gg          , Gg          , Gs^Fp       , Gs^Fp       , Gg          , Gg          , Gg          , Gg          , Gg          , Gg          , Ss^Bw/r     , Xu          , Xu          , Xu          , Xu          , Wwf         , Wwf         , Ww          , Ww          , Wwf         , Wwf         , Xu          , Qxu         , Qxu         
Qxu         , Qxu         , Xu          , Ss          , Mm          , Hh          , Gs^Fp       , Gs          , Xu          , Gs^Fp       , Gs^Fp       , Gs^Fp       , Hh          , Gg          , Gg          , Gg          , Gg          , Gg          , Gs^Fp       , Gs^Fp       , Hh          , Gg          , Xu          , Xu          , Xu          , Xu          , Wwf         , Wwf         , Ww          , Ww          , Wwf         , Wwf         , Xu          , Xu          , Xu          , Qxu         , Qxu         
Qxu         , Qxu         , Xu          , Hh          , Hh          , Hh          , Gs^Fp       , Gg          , Hh          , Xu          , Xu          , Hh          , Mm          , Hh          , Gg          , Gg          , Gg          , Gg          , Hh          , Mm          , Xu          , Xu          , Xu          , Xu          , Wwf         , Wwf         , Ww          , Ww          , Wwf         , Wwf         , Xu          , Xu          , Xu          , Xu          , Xu          , Qxu         , Qxu         
Qxu         , Qxu         , Xu          , Gs^Fp       , Gs^Fp       , 2 Kh        , Gg          , Gg          , Gs^Fp       , Mm          , Hh          , Xu          , Xu          , Hh          , Gg          , Gg          , Gg          , Gg          , Mm          , Xu          , Xu          , Xu          , Uu          , Wwf         , Ww          , Ww          , Wwf         , Wwf         , Xu          , Xu          , Uh          , Uh          , Uh          , Xu          , Xu          , Qxu         , Qxu         
Qxu         , Qxu         , Xu          , Hh          , Hh          , Gg          , Gg          , Gg          , Gs^Fp       , Hh          , Hh          , Mm          , Hh          , Xu          , Gg          , Gg          , Gg          , Gs^Fp       , Hh          , Xu          , Xu          , Uu          , Uu          , Rr          , Rr          , Wwf         , Xu          , Xu          , Uh          , Uh          , Uu          , Uu          , Uu          , Uh          , Xu          , Qxu         , Qxu         
Qxu         , Qxu         , Xu          , Md          , Hd          , Gg          , Hh          , Gg          , Gg          , Gs^Fp       , Gs^Fp       , Gs^Fp       , Gg          , Gg          , Gg          , Gg          , Gg          , Gs^Fp       , Mm          , Xu          , Xu          , Uu^Uf       , Uu^Uf       , Rr          , Rr          , Uu          , Uu          , Uh          , Uu          , Uu          , Uh          , Uh          , Uh          , Uh          , Xu          , Qxu         , Qxu         
Qxu         , Qxu         , Xu          , Md          , Hd          , Re          , Re          , Mm          , Hh          , Gg          , Gg          , Gg          , Gg          , Gg          , Gg          , Chr         , Gg          , Gg          , Hh          , Xu          , Xu          , Ss          , Ss          , Uu^Uf       , Uu^Uf       , Rr          , Rr          , Uu          , Uh          , Uh          , Xu          , Xu          , Xu          , Uh          , Xu          , Qxu         , Qxu         
Qxu         , Qxu         , Xu          , Md          , Hd          , Dd          , Re          , Dd          , Dd          , Gg          , Hh          , Gg          , Gg          , Gg          , Chr         , 6 Kh        , Chr         , Gg          , Mm          , Xu          , Xu          , Ss          , Ss          , Ss          , Xu          , Uu^Uf       , Uu          , Rr          , Cud         , Xu          , Rd          , Rd          , Rd          , Xu          , Xu          , Qxu         , Qxu         
Qxu         , Qxu         , Xu          , Md          , Hd          , Dd          , Re          , Dd          , Hd          , Hd          , Md          , Hh          , Wwf         , Wwf         , Wwf         , Wwf         , Wwf         , Wwf         , Wwf         , Xu          , Xu          , Ss          , Ss          , Ss          , Xu          , Uu^Uf       , Uu          , Uu          , Xu          , Rd          , Chr         , Chr         , Chr         , Rd          , Xu          , Qxu         , Qxu         
Qxu         , Qxu         , Xu          , Md          , Hd          , Dd          , Dd          , Dd          , Hd          , Md          , Xu          , Xu          , Ww          , Ww          , Ww          , Ww          , Ww          , Ww          , Ww          , Xu          , Xu          , Ss          , Chs         , Ss          , Xu          , Uu^Uf       , Uu          , Uu^Uf       , Xu          , Rd          , Chr         , 9 Kh        , Chr         , Rd          , Xu          , Qxu         , Qxu         
Qxu         , Qxu         , Xu          , Md          , Hd          , Hd          , Hd          , Hd          , Hd          , Md          , Xu          , Xu          , Ww          , Ww          , Ww          , Ww          , Ww          , Ww          , Ww          , Xu          , Xu          , Chs         , Chs         , Chs         , Xu          , Uu^Uf       , Uu          , Uu^Uf       , Xu          , Rd          , Rd          , Chr         , Rd          , Rd          , Xu          , Qxu         , Qxu         
Qxu         , Qxu         , Xu          , Md          , Md          , Md          , Md          , Md          , Md          , Md          , Xu          , Xu          , Wo          , Wo          , Wo          , Wo          , Wo          , Wo          , Wo          , Xu          , Xu          , Chs         , Chs         , Chs         , Xu          , Uu^Uf       , Uu^Uf       , Uu          , Xu          , Xu          , Xu          , Rd          , Xu          , Xu          , Xu          , Qxu         , Qxu         
Qxu         , Qxu         , Qxu         , Xu          , Xu          , Xu          , Xu          , Xu          , Xu          , Xu          , Xu          , Xu          , Xu          , Xu          , Xu          , Xu          , Xu          , Xu          , Xu          , Xu          , Xu          , Xu          , Xu          , Xu          , Xu          , Xu          , Xu          , Xu          , Xu          , Xu          , Xu          , Xu          , Xu          , Xu          , Qxu         , Qxu         , Qxu         
Qxu         , Qxu         , Qxu         , Qxu         , Qxu         , Qxu         , Qxu         , Qxu         , Qxu         , Qxu         , Qxu         , Qxu         , Qxu         , Qxu         , Qxu         , Qxu         , Qxu         , Qxu         , Qxu         , Qxu         , Qxu         , Qxu         , Qxu         , Qxu         , Qxu         , Qxu         , Qxu         , Qxu         , Qxu         , Qxu         , Qxu         , Qxu         , Qxu         , Qxu         , Qxu         , Qxu         , Qxu         
Qxu         , Qxu         , Qxu         , Qxu         , Qxu         , Qxu         , Qxu         , Qxu         , Qxu         , Qxu         , Qxu         , Qxu         , Qxu         , Qxu         , Qxu         , Qxu         , Qxu         , Qxu         , Qxu         , Qxu         , Qxu         , Qxu         , Qxu         , Qxu         , Qxu         , Qxu         , Qxu         , Qxu         , Qxu         , Qxu         , Qxu         , Qxu         , Qxu         , Qxu         , Qxu         , Qxu         , Qxu         
