Xu, Xu, Xu, Xu, Xu, Xu, Xu, Xu, Xu, Xu, Xu, Xu, Xu, Xu, Xu, Xu, Xu, Xu, Xu, Xu, Xu, Xu, Xu, Xu, Xu, Xu, Xu, Xu, Xu, Xu, Xu, Xu, Xu, Xu, Xu, Xu, Xu, Xu, Xu, Xu, Xu, Xu, Xu, Xu, Xu, Xu, Xu, Xu, Xu, Xu, Xu, Xu
Xu, Xu, Xu, Xu, Re, Re, Re, Re, Re, Xu, Qxu, Xu, Qxu, Qxu, Qxu, Xu, Qxu, Xu, Xu, Xu, Qxu, Qxu, Qxu, Qxu, Qxu, Xu, Xu, Xu, Xu, Xu, Xu, Xu, Xu, Xu, Xu, Xu, Xu, Xu, 9 Kud, Cud, Cud, Xu, Xu, Xu, Cud, Xu, Xu, Xu, Xu, Xu, Xu, Xu
Xu, Xu, Xu, Xu, Re, Re, 8 Kud, Re, Re, Uh, Xu, Qxu, Xu, Xu, Rp, Qxu, Qxu, Qxu, Xu, Xu, Xu, Rp, Xu, Qxu, Xu, Xu, Xu, Xu, Rp, Rp, Xu, Rp, Rp, Xu, Xu, Cud, Xu, Cud, Cud, Cud, Ur, Uu, Uu, Uu, Uh, Uu, Xu, Cud, Cud, Cud, Xu, Xu
Xu, Xu, Xu, Re, Cud, Cud, Cud, Cud, Cud, Re, Uh, Xu, Xu, Xu, Xu, Xu, Qxu, Qxu, Qxu, Qxu, Qxu, Xu, Xu, Xu, Xu, Uh, Hh^Fp, Xu, Xu, Rp, Xos, Rp, Rp, Xu, Xu, Rp, Xu, Cud, Uu, Ur, Ur, Ur, Ur, Uu, Ql, Uu, Xu, Cud, Cud, Cud, Xu, Xu
Xu, Xu, Xu, Re, Cud, Re, Re, Re, Cud, Re, Re, Re, Re, Xu, Uu^Uf, Xu, Uh, Xu, Xu, Xu, Xu, Qxu, Xu, Xu, Gg, Gg, Xu, Xu, Xu, Xu, Rp, Xu, Xu, Xu, Xu, Rp, Xu, Uu, Uu, Uu, Uu, Ur, Ur, Ur, Ql, Ql, Xu, Cud, Cud, Cud, Xu, Xu
Xu, Xu, Xu, Re, Re, Re, Re, Re, Re, Re, Xu, Re, Xu, Cud, Re, Re, Re, Xu, Xu, Cud, Xu, Qxu, Cud, Gg, Hh^Fp, Gs^Fp, Xu, Rp, Xu, Rp, Rp, Xu, Cud, Cud, Cud, Xu, Xu, Uu, Uu, Uu, Uu, Uu, Ur, Ur, Ur, Uu, Ur, Ur, Ur, Ur, Xu, Xu
Xu, Xu, Xu, Xu, Xu, Re, Cud, Re, Xu, Xu, Xu, Xu, Xu, Xu, Re, Re, Re, Re, Re, Re, Re, Re, Re, Re, Re, Ss, Xu, Rp, Xu, Xu, Xu, Xu, Xu, Cud, Xu, Xu, Xu, Uu, Cud, Uu, Uu, Ql, Ql, Ur, Ur, Ur, Ur, Ur, Ur, Ur, Xu, Xu
Xu, Xu, Rp, Rp, Xu, Cud, Re, Cud, Xu, Rp, Rp, Xu, Xu, Xu, Xu, Re, Xu, Re, Xu, Xu, Xu, Re, Cud, Re, Re, Ss, Ss, Xu, Rp, Rp, Xu, Rp, Rp, Rp, Rp, Rp, Xu, Xu, Qxu, Uu, Qxu, Uu, Xu, Xu, Qxu, Xu, Cud, Ur, Cud, Xu, Xu, Xu
Xu, Cud, Rp, Rp, Xu, Re, Re, Re, Xu, Rp, Rp, Cud, Xu, Xu, Cud, Xu, Rp, Xu, Xu, Xu, Qxu, Qxu, Qxu, Uh, Gg, Re, Ss, Ds, Ds, Xu, Rp, Rp, Rp, Rp, Rp, Xu, Gs, Qxu, Xu, Xu, Gs^Fp, Qxu, Gs^Fp, Qxu, Qxu, Xu, Cud, Cud, Cud, Xu, Ur, Xu
Xu, Xu, Xu, Rp, Xu, Cud, Cud, Cud, Xu, Rp, Xu, Xu, Qxu, Rp, Rp, Xu, Rp, Rp, Xu, Qxu, Qxu, Xu, Xu, Xu, Xu, Re, Re, Ss, Xu, Xu, Rp, Rp, Rp, Rp, Rp, Xu, Gs, Gg, Gs^Fp, Gs^Fp, Gs^Fp, Gs^Fp, Wwf, Wwf, Gs^Fp, Xu, Cud, Cud, Cud, Xu, Xu, Xu
Xu, Xu, Xu, Xu, Re, Re, Re, Re, Re, Xu, Xu, Qxu, Qxu, Rp, Qxu, Xu, Xu, Xu, Xu, Xu, Xu, Qxu, Xu, Xu, Uh, Xu, Re, Gs^Fp, Gs^Fp, Xu, Rp, Rp, Rp, Rp, Rp, Xu, Gg, Gg, Gg, Gs^Fp, Gs, Xu, Wwf, Wwf, Gs^Fp, Xu, Cud, Cud, Cud, Qxu, Ur, Xu
Xu, Xu, Xu, Xu, Re, Re, Re, Re, Re, Re, Re, Xu, Qxu, Rp, Rp, Qxu, Qxu, Xu, Qxu, Xu, Qxu, Uh, Uh, Uh, Hh^Fp, Hh^Fp, Re, Gs^Fp, Gs^Fp, Xu, Xu, Rp, Rp, Rp, Xu, Xu, Gg, Gg, Wwf, Gg, Wwf, Wwf, Gs, Gs^Fp, Gs^Fp, Xu, Cud, Cud, Cud, Xu, Xu, Xu
Xu, Xu, Xu, Xu, Re, Re, Re, Re, Re, Re, Xu, Xu, Rp, Rp, Rp, Uh, Xu, Qxu, Rp, Qxu, Xu, Uh, Hh^Fp, Xu, Gg, Hh^Fp, Xu, Re, Re, Gs, Xu, Cud, Cud, Cud, Xu, Gg, Wwf, Wwf, Wwf, Wwf, Gs, Wwf, Wwf, Gs^Fp, Gs^Fp, Xu, Cud, Cud, Cud, Xu, Ur, Xu
Xu, Xu, Cud, Re, Re, Re, Re, Re, Re, Re, Re, Xu, Xu, Rp, Rp, Xu, Xu, Xu, Xu, Xu, Xu, Xu, Gs^Fp, Gg, Gg, Xu, Gs^Fp, Gs^Fp, Gs^Fp, Re, Gg, Gs, Re, Gs, Gg, Ds, Wwf, Wwf, Xu, Gs, Qxu, Wwf, Wwf, Gs, Ur, Xu, Ur, Ur, Ur, Xu, Xu, Xu
Xu, Xu, Cud, Re, Re, Re, Re, Re, Xu, Re, Re, Re, Re, Xu, Xu, Xu, Xu, Xu, Xu, Xu, Re, Gs^Fp, Re, Re, Re, Re, Re, Gs^Fp, Re, Re, Re, Re, Gs^Fp, Gg, Wwf, Wwf, Mm, Xu, Xu, Qxu, Qxu, Xu, Xu, Wwf, Ur, Ur, Ur, Ur, Ur, Xu, Ur, Xu
Xu, Xu, Xu, Cud, Re, Re, Xu, Xu, Xu, Re, Re, Re, Re, Re, Re, Uu^Uf, Re, Cud, Re, Re, Re, Re, Ds, Gg, Hh, Gs^Fp, Ds, Re, Re, Gs^Fp, Mm, Gs, Gs^Fp, Gs^Fp, Wwf, Ds, Hh, Hh^Fp, Qxu, Qxu, Qxu, Xu, Xu, Xu, Qxu, Ur, Ur, Ur, Ur, Xu, Xu, Xu
Xu, Cud, Xu, Xu, Xu, Uu^Uf, Xu, Xu, Xu, Xu, Re, Re, Xu, Re, Re, Re, Re, Xu, Xu, Xu, Xu, Hh^Fp, Hh^Fp, Hh^Fp, Hh, Gs^Fp, Mm, Hh^Fp, Re, Re, Re, Gs, Wwf, Wwf, Xu, Gs, Ds, Hh^Fp, Xu, Xu, Xu, Qxu, Qxu, Qxu, Xu, Xu, Cud, Ur, Cud, Xu, Ur, Xu
Xu, Rp, Xu, Re, Xu, Xu, Xu, Re, Xu, Xu, Re, Re, Xu, Xu, Xu, Re, Cud, Xu, Cud, Xu, Xu, Xu, Xu, Hh^Fp, Gs^Fp, Gs^Fp, Xu, Hh^Fp, Mm, Hh^Fp, Xu, Re, Wwf, Wwf, Wwf, Gs, Ds, Hh, Xu, Xu, Xu, Qxu, Qxu, Xu, Uu^Uf, Xu, Ur, Ur, Ur, Xu, Xu, Xu
Xu, Cud, Cud, Xu, Xu, Re, Xu, Xu, Xu, Xu, Cud, Re, Re, Xu, Uu^Uf, Re, Re, Xu, Xu, Cud, Cud, Xu, Xu, Xu, Xu, Xu, Xu, Wwf, Xu, Xu, Ss, Wwf, Chw, Ww, Chw, Wwf, Ss, Uh, Xu, Xu, Qxu, Qxu, Xu, Xu, Uh, Xu, Cud, Ur, Cud, Xu, Ur, Xu
Xu, Cud, Cud, Cud, Xu, Xu, Xu, Xu, Xu, Xu, Xu, Uu, Re, Uu, Re, Re, Re, Re, Re, Xu, Xu, Cud, Cud, Xu, Xu, Xu, Xu, Wwf, Wo, Ss, Ww, Ss, Chw, 7 Khw, Chw, Wwf, Ww, Ss, Xu, Xu, Uh, Qxu, Xu, Xu, Uu^Uf, Xu, Ur, Ur, Ur, Xu, Qxu, Xu
Xu, Cud, Cud, Cud, Xu, Xu, Uu^Uf, Uu, Uu, Xu, Xu, Xu, Xu, Re, Re, Re, Re, Re, Re, Re, Re, Xu, Xu, Cud, Xu, Xu, Xu, Hh^Fp, Wo, Wo, Ww, Chw, Wwf, Ww, Wwf, Chw, Ww, Wo, Ww, Ss, Xu, Xu, Xu, Xu, Xu, Xu, Cud, Ur, Cud, Xu, Qxu, Xu
Xu, Xu, Xu, Xu, Xu, Uu, Uu, Xu, Xu, Xu, Uu^Uf, Xu, Xu, Xu, Xu, Re, Re, Re, Re, Re, Re, Re, Xu, Cud, Xu, Xu, Xu, Wwf, Ww, Wo, Chw, Wwf, Wwf, Wwf, Wwf, Wwf, Chw, Wo, Ww, Ww, Ds, Hh^Fp, Hh^Fds, Mm, Hh^Fds, Xu, Gs, Cud, Gg, Xu, Xu, Xu
Xu, Rp, Xu, Xu, Uh, Uh, Uu, Xu, Xu, Xu, Uu, Xu, Uu, Re, Re, Xu, Re, Re, Re, Re, Re, Re, Xu, Cud, Xu, Xu, Mm, Gs^Fms, Gs^Fms, Ww, Ww, Ww, Wwf, Wwf, Wwf, Ww, Ww, Ww, Ww, Ww, Dd^Dc, Gs, Ds, Hh^Fp, Gg, Gs, Gs, Gg, Gg, Gg, Hh, Xu
Xu, Rp, Xu, Uu, Xu, Uh, Xu, Uu, Uu, Uu, Uu, Uu, Xu, Re, Re, Re, Re, Re, Re, Re, Xu, Xu, Cud, Cud, Xu, Xu, Mm, Gs^Fds, Gs, Ww, Ww, Ww, Wwf, Ww, Wo, Wwf, Wwf, Ww, Gs, Ds, Gs, Gs, Ss, Gg, Ss, Gg, Gg, Gg, Gg, Gs, Hh^Fp, Xu
Xu, Rp, Xu, Wwf, Ww, Xu, Xu, Uu^Uf, Xu, Xu, Uu, Xu, Xu, Re, Re, Re, Re, Re, Xu, Xu, Cud, Cud, Xu, Xu, Gs^Fp, Wo, Ww, Gs, Ww, Wo, Ww, Ww, Wwf, Wwf, Wwf, Wo, Wwf, Wwf, Ww, Gs, Ds, Gs^Fp, Gs^Fp, Ss, Ss, Gs, Gg, Gg, Gg, Gs^Fp, Mm, Xu
Xu, Cud, Xu, Wwf, Wo, Xu, Xu, Xu, Xu, Xu, Uu^Uf, Xu, Xu, Re, Re, Re, Xu, Xu, Cud, Cud, Xu, Xu, Mm, Mm, Hh, Ww, Wo, Wwf, Wwf, Ww, Wwf, Wwf, Ww, Ww, Wo, Wwf, Wwf, Ww, Ww, Gs, Hh, Gs^Fp, Hh, Gs^Fp, Ds, Ss, Ds, Gg, Gg, Gs, Hh^Fp, Xu
Xu, Xu, Xu, Wwf, Ww, Xu, Xu, Xu, Uu, Xu, Xu, Xu, Xu, Cud, Cud, Cud, Xu, Xu, Xu, Xu, Xu, Mm, Gs^Fp, Mm, Hh^Fp, Wo, Wo, Wwf, Wo, Wwf, Hh^Fp, Ds, Gs^Fp, Ww, Hh^Fp, Wo, Wwf, Ww, Ds, Ds, Hh, Hh^Fms, Gs^Fp, Mm, Hh, Gs, Gg, Gg, Gg, Hh, Mm, Xu
Xu, Xu, Xu, Wwf, Uu, Xu, Xu, Uh, Uu, Xu, Xu, Xu, Rd, Rd, Rd, Rd, Rd, Xu, Wo, Wwf, Wo, Xu, Wo, Hh^Fms, Hh^Fp, Gg^Efm, Wwf, Wwf, Wwf, Wwf, Gs, Hh, Mm, Hh^Fms, Hh^Fp, Ds, Wwf, Wwf, Gs, Mm, Hh, Mm, Hh, Gs^Fp, Gs^Fp, Gg, Gg, Gg^Efm, Gg, Ss, Hh, Xu
Xu, Xu, Xu, Xu, Uu, Xu, Uu, Uu, Xu, Xu, Xu, Xu, Rd, Rd, Xu, Rd, Rd, Xu, Xu, Wwf, Wwf, Xu, Wo, Ww, Ds, Gs^Fp, Wo, Wwf, Gs^Fp, Hh^Fp, Gg^Efm, Mm, Mm, Mm, Ds, Hh, Wwf, Ww, Ww, Gs^Fp, Hh, Hh^Fp, Hh^Fms, Gs^Fp, Gs^Fds, Hh, Gs, Gg, Gg, Ss, Gs^Fp, Xu
Xu, Xu, Uh, Xu, Uu, Uu, Uu^Uf, Xu, Xu, Xu, Xu, Xu, Rd, Rd, Rd, Rd, Rd, Xu, Xu, Xu, Uu, Xu, Xu, Ww, Ww, Wo, Wwf, Wwf, Wo, Mm, Mm, Wwf, Wwf, Gs^Fp, Ww, Wwf, Wwf, Ww, Ds, Hh^Fp, Hh^Fp, Mm, Gs^Fp, Gs^Fp, Ss, Gs^Fp, Gs, Gs, Ds, Gs^Fp, Gs^Fp, Xu
Xu, Xu, Uh, Xu, Uu, Uu, Xu, Xu, Xu, Xu, Xu, Xu, Xu, Rd, Xu, Rd, Xu, Xu, Uu^Uf, Uu, Xu, Uh, Uu, Xu, Ww, Ww, Wwf, Wwf, Gg, Ss, Gs^Fp, Wwf, Wo, Wo, Ww, Ww, Wwf, Ww, Ds, Ss, Gs^Fp, Hh^Fms, Hh^Fp, Ss, Ds, Gs, Gg, Gg, Hh^Fms, Gs^Fp, Mm, Xu
Xu, Xu, Xu, Xu, Uu, Uh, Uh, Xu, Uu, Uu, Uu, Uu^Uf, Xu, Rd, Rd, Rd, Xu, Xu, Xu, Xu, Wo, Xu, Xu, Ss, Ww, Ww, Wwf, Wwf, Ds, Hh^Fms, Gs^Fds, Wwf, Wwf, Ww, Gg, Wwf, Rd, Gg, Gg, Ds, Gg, Hh^Fp, Gg, Gg^Efm, Gs, Gg, Gs^Fp, Hh^Fds, Hh^Fds, Hh^Fds, Mm, Xu
Xu, Xu, Xu, Uh, Uu, Uh, Uh, Uu, Xu, Xu, Xu, Xu, Xu, Rd, Rd, Rd, Xu, Xu, Wo, Xu, Ww, Ww, Ss, Ss, Wwf, Wwf, Ww, Wo, Wo, Gs, Ww, Wwf, Gg, Gg, Gg, Gg, Rd, Gg, Gs, Gs, Gs, Gs, Gs, Gg, Gg, Gg, Ds, Hh, Mm, Mm, Mm, Xu
Xu, Xu, Xu, Uu, Uu, Uu, Xu, Xu, Xu, Xu, Xu, Mm, Mm, Xu, Re, Rd, Rd, Xu, Hh^Fp, Ww, Hh^Fp, Gs^Fp, Gs^Fp, Gs^Fp, Hh^Fms, Wwf, Ds, Wo, Ww, Wwf, Ww, Ww, Gg, Gg, Rd, Rd, Gg, Gg, Gg, Gg, Gg^Efm, Gs, Gg, Gg, Gg, Gg, Ss, Hh^Fp, Hh^Fp, Mm, Xu, Xu
Xu, Xu, Xu, Xu, Xu, Xu, Xu, Xu, Xu, Xu, Xu, Hh, Re, Re, Gs^Fp, Re, Gs^Fp, Rd, Rd, Ww, Hh, Hh^Fms, Mm, Mm, Hh^Fp, Ww, Wo, Gs^Fp, Hh^Fp, Wwf, Ss, Gg, Re, Rd, Gg, Gg, Ds, Gg, Ds, Ds, Gg, Gg, Gs^Ft, Gs^Ft, Ds, Ss, Gs^Fp, Gs^Fds, Hh^Fp, Hh^Fp, Xu, Xu
Xu, Xu, Xu, Xu, Xu, Xu, Xu, Xu, Xu, Xu, Xu, Mm, Re, Gs^Fp, Gs^Fp, Re, Gs^Fds, Hh^Fp, Re, Ww^Bw\, Rd, Gs^Fp, Hh^Fp, Gs^Fp, Ww, Ww, Ds, Mm, Gg, Gg, Re, Ss^Bw/, Ss, Gs, Gs, Gg, Gg, Gg, Ds, Ds, Gs, Ds, Ds, Gs^Ft, Xu, Gs^Fp, Gs^Fds, Ss, Ss, Hh^Fp, Xu, Xu
Xu, Xu, Xu, Xu, Xu, Xu, Xu, Xu, Xu, Xu, Xu, Xu, Re, Re, Re, Re, Re, Re, Hh, Ww, Ds, Rd, Rd, Hh^Fp, Ss, Ss, Ss, Ds, Rd, Rd, Ds, Ds, Ss, Ss, Ss, Gs, Ss, Ds, Ds, Gs, Ss, Gs, Ss, Xu, Xu, Xu, Xu, Hh^Fp, Ss, Xu, Xu, Xu
Xu, Xu, Xu, Xu, Xu, Xu, Xu, Xu, Xu, Xu, Xu, Cud, Re, Gg^Fet, Re, Gs^Fp, Gs^Fp, Mm, Hh^Fp, Ww, Ww, Hh, Re, Rd, Rd, Ds, Rd, Rd, Gs^Fp, Gs^Fp, Ss, Ss, Ds, Ds, Ds, Ss, Ds, Ss, Ds, Ds, Xu, Ss, Ss, Xu, Xu, Uu^Uf, Uh, Xu, Ds, Xu, Xu, Xu
Xu, Xu, Xu, Xu, Xu, Xu, Xu, Xu, Xu, Xu, Xu, Gs^Fp, Gs^Fp, Re, Gs^Fp, Re, Re, Re, Re, Ss, Re, Wwf, Ww, Gg, Ds, Rd, Gg, Gs^Fp, Dd, Ss, Ss, Ss, Ss, Ds, Ds, Ss, Ss, Ds, Ds, Md, Hd, Xu, Ss, Ss, Xu, Xu, Xu, Hd, Gs^Ft, Gs^Ft, Xu, Xu
Xu, Xu, Xu, Xu, Xu, Xu, Xu, Xu, Xu, Xu, Xu, Xu, Xu, Gs^Fp, Gs^Fp, Gs^Fp, Gs^Fp, Hh, Hh^Fp, Re, Hh, Ds, Ww, Ww, Gg, Rd, Gg, Gs, Ds, Ss, Ds, Ds, Ds, Ds, Ss, Ds, Ss, Ds, Ds, Ds, Ds, Ds, Ss, Xu, Ss, Ss, Ss, Ds, Xu, Gs^Ft, Gs^Ft, Xu
Xu, Xu, Xu, Xu, Xu, Xu, Xu, Xu, Xu, Xu, Xu, Xu, Xu, Xu, Xu, Xu, Xu, Hh^Fp, Xu, Mm, Ww, Ww, Gs^Fp, Gs^Fp, Gg, Rd, Gg, Gs, Xu, Ds, Ds, Hd, Md, Ds, Ds, Ss, Ss, Ds, Xu, Ds, Ds, Ds, Ds, Ds, Hd, Ss, Ss, Xu, Ds, Gs^Ft, Xu, Xu
Xu, Xu, Xu, Xu, Xu, Xu, Xu, Xu, Xu, Xu, Xu, Xu, Xu, Xu, Xu, Xu, Xu, Xu, Xu, Wo, Xu, Hh^Fp, Xu, Mm, Xu, Rd, Xu, Hh^Fp, Xu, Ds, Xu, Xu, Xu, Xu, Xu, Xu, Xu, Ss, Xu, Hd, Gs^Ft, Md, Xu, Ds, Ds, Xu, Ss, Ss, Ss, Ds, Md, Xu
Xu, Xu, Xu, Xu, Xu, Xu, Xu, Xu, Xu, Xu, Xu, Xu, Xu, Xu, Xu, Xu, Xu, Xu, Xu, Xu, Xu, Xu, Xu, Xu, Xu, Cud, Xu, Xu, Xu, Xu, Uu, Xu, Uh, Uh, Uu^Uf, Xu, Xu, Ss, Hd, Gs^Ft, Xu, Xu, Ds, Ss, Ds, Ds, Ds, Ss, Xu, Hd, Md, Xu
Xu, Xu, Xu, Xu, Xu, Xu, Xu, Xu, Xu, Xu, Xu, Xu, Xu, Xu, Xu, Xu, Xu, Xu, Xu, Xu, Xu, Uh, Xu, Rp, Xu, Rp, Xu, Rp, Xu, Uu, Xu, Uu, Xu, Xu, Xu, Xu, Xu, Xu, Xu, Hd, Ss, Ds, Xu, Xu, Ss, Ds, Ds, Ds, Xu, Xu, Xu, Xu
Xu, Xu, Xu, Xu, Xu, Xu, Xu, Xu, Xu, Xu, Xu, Xu, Xu, Xu, Xu, Xu, Xu, Xu, Xu, Xu, Xu, Uh, Xu, Rp, Xu, Rp, Xu, Rp, Xu, Xu, Wo, Wwf, Xu, Xu, Uu, Xu, Xu, Xu, Xu, Xu, Ss, Ss, Ss, Ss, Ss, Xu, Ds, Ds, Xu, Ss, Xu, Xu
Xu, Xu, Xu, Xu, Xu, Xu, Xu, Xu, Xu, Xu, Xu, Xu, Xu, Xu, Xu, Xu, Xu, Xu, Xu, Xu, Xu, Xu, Xu, Xu, Rp, Rp, Rp, Xu, Xu, Xu, Xu, Wwf, Uh, Uh, Xu, Xu, Xu, Xu, Xu, Hd, Ss, Xu, Xu, Ss, Ds, Ds, Ds, Ds, Ss, Xu, Md, Xu
Xu, Xu, Xu, Xu, Xu, Xu, Xu, Xu, Xu, Xu, Xu, Xu, Xu, Xu, Xu, Xu, Xu, Xu, Xu, Xu, Xu, Xu, Xu, Cud, Rp, Rp, Rp, Cud, Xu, Xu, Xu, Xu, Uu, Uh, Xu, Uh, Uh, Xu, Xu, Xu, Xu, Ss, Ds, Xu, Xu, Ss, Chs, Ds, Chs, Ss, Xu, Xu
Xu, Xu, Xu, Xu, Xu, Xu, Xu, Xu, Xu, Xu, Xu, Xu, Xu, Xu, Xu, Xu, Xu, Xu, Xu, Xu, Xu, Xu, Xu, Xu, 1 Rp, Rp, 5 Rp, Xu, Xu, Uh, Uh, Uu, Xu, Xu, Xu, Xu, Uh, Xu, Xu, Xu, Uh, Ss, Ds, Xu, Ss, Chs, Chs, Chs, Chs, Chs, Xu, Xu
Xu, Xu, Xu, Xu, Xu, Xu, Xu, Xu, Xu, Xu, Xu, Xu, Xu, Xu, Xu, Xu, Xu, Xu, Xu, Xu, Xu, Xu, Xu, Xu, 2 Rp, Rp, 4 Rp, Xu, Xu, Xu, Uu^Uf, Xu, Xu, Xu, Xu, Uu^Uf, Xu, Xu, Uu^Uf, Uu, Xu, Xu, Xu, Ds, Xu, Chs, Chs, Chs, Chs, Chs, Xu, Xu
Xu, Xu, Xu, Xu, Xu, Xu, Xu, Xu, Xu, Xu, Xu, Xu, Xu, Xu, Xu, Xu, Xu, Xu, Xu, Xu, Xu, Xu, Xu, Xu, Xu, 3 Rp, Xu, Xu, Xu, Xu, Xu, Xu, Xu, Xu, Xu, Xu, Xu, Xu, Xu, Xu, Xu, Xu, Xu, Xu, Xu, Xu, Xu, 6 Khs, Xu, Xu, Xu, Xu
Xu, Xu, Xu, Xu, Xu, Xu, Xu, Xu, Xu, Xu, Xu, Xu, Xu, Xu, Xu, Xu, Xu, Xu, Xu, Xu, Xu, Xu, Xu, Xu, Xu, Xu, Xu, Xu, Xu, Xu, Xu, Xu, Xu, Xu, Xu, Xu, Xu, Xu, Xu, Xu, Xu, Xu, Xu, Xu, Xu, Xu, Xu, Xu, Xu, Xu, Xu, Xu
Xu, Xu, Xu, Xu, Xu, Xu, Xu, Xu, Xu, Xu, Xu, Xu, Xu, Xu, Xu, Xu, Xu, Xu, Xu, Xu, Xu, Xu, Xu, Xu, Xu, Xu, Xu, Xu, Xu, Xu, Xu, Xu, Xu, Xu, Xu, Xu, Xu, Xu, Xu, Xu, Xu, Xu, Xu, Xu, Xu, Xu, Xu, Xu, Xu, Xu, Xu, Xu
