border_size=1
usage=map

_off^_usr   , _off^_usr   , _off^_usr   , _off^_usr   , _off^_usr   , _off^_usr   , _off^_usr   , _off^_usr   , _off^_usr   , _off^_usr   , _off^_usr   , _off^_usr   , _off^_usr   , _off^_usr   , _off^_usr   , _off^_usr   , _off^_usr   , _off^_usr   , _off^_usr   , _off^_usr   , _off^_usr   , _off^_usr   
_off^_usr   , _off^_usr   , _off^_usr   , _off^_usr   , _off^_usr   , _off^_usr   , _off^_usr   , _off^_usr   , _off^_usr   , _off^_usr   , _off^_usr   , _off^_usr   , _off^_usr   , _off^_usr   , _off^_usr   , _off^_usr   , _off^_usr   , _off^_usr   , _off^_usr   , _off^_usr   , _off^_usr   , _off^_usr   
_off^_usr   , _off^_usr   , _off^_usr   , _off^_usr   , _off^_usr   , _off^_usr   , _off^_usr   , _off^_usr   , _off^_usr   , _off^_usr   , _off^_usr   , _off^_usr   , _off^_usr   , _off^_usr   , _off^_usr   , _off^_usr   , _off^_usr   , _off^_usr   , _off^_usr   , _off^_usr   , _off^_usr   , _off^_usr   
_off^_usr   , _off^_usr   , _off^_usr   , _off^_usr   , _off^_usr   , _off^_usr   , _off^_usr   , _off^_usr   , Hh          , Gg          , Ch          , 7 Kh        , Ch          , Hh          , Ss          , _off^_usr   , _off^_usr   , _off^_usr   , _off^_usr   , _off^_usr   , _off^_usr   , _off^_usr   
_off^_usr   , _off^_usr   , _off^_usr   , _off^_usr   , _off^_usr   , _off^_usr   , _off^_usr   , _off^_usr   , Gs^Fp       , Hh          , Ww          , Ch          , Gg          , Gs^Fp       , Ss          , _off^_usr   , _off^_usr   , _off^_usr   , _off^_usr   , _off^_usr   , _off^_usr   , _off^_usr   
_off^_usr   , _off^_usr   , _off^_usr   , _off^_usr   , _off^_usr   , _off^_usr   , _off^_usr   , _off^_usr   , _off^_usr   , Gg          , Ww^Bw/      , Ch          , Gg          , Gg          , _off^_usr   , _off^_usr   , _off^_usr   , _off^_usr   , _off^_usr   , _off^_usr   , _off^_usr   , _off^_usr   
_off^_usr   , _off^_usr   , _off^_usr   , _off^_usr   , _off^_usr   , _off^_usr   , _off^_usr   , _off^_usr   , _off^_usr   , Gg          , Ww          , Ww          , Ww          , Ss          , _off^_usr   , _off^_usr   , _off^_usr   , _off^_usr   , _off^_usr   , _off^_usr   , _off^_usr   , _off^_usr   
_off^_usr   , _off^_usr   , _off^_usr   , _off^_usr   , _off^_usr   , _off^_usr   , _off^_usr   , _off^_usr   , Ds          , Gg          , Wwf         , Gg          , Hh          , Ss          , Ss          , _off^_usr   , _off^_usr   , _off^_usr   , _off^_usr   , _off^_usr   , _off^_usr   , _off^_usr   
_off^_usr   , _off^_usr   , _off^_usr   , Ss          , Ss          , _off^_usr   , Ww          , Gg          , Ww          , Wwf         , Ds          , Gg          , Gs^Fp       , Gs^Fp       , Gg          , Ww          , Ds          , _off^_usr   , Gs^Fp       , Hh          , _off^_usr   , _off^_usr   
_off^_usr   , _off^_usr   , _off^_usr   , Gg          , Ss          , Ss          , Ss          , Ww          , Ds          , Gg          , Hh          , Gg          , Gg          , Gg          , Ds          , Wwf         , Gg          , Gg          , Gg          , Hh          , _off^_usr   , _off^_usr   
_off^_usr   , _off^_usr   , _off^_usr   , Ch          , Ch          , Gs^Fp       , Ss          , Gg          , Hh          , Chs         , 2 Gs^Fp     , 3 Hh        , Gs^Fp       , Gg          , Gg          , Wwf         , Ww          , Gg          , Ch          , Ch          , _off^_usr   , _off^_usr   
_off^_usr   , _off^_usr   , _off^_usr   , 9 Kh        , Ch          , Hh          , Ww          , Gg          , Gg          , Gs^Fp       , 1 Gs^Fp     , Gg          , 4 Gs^Fp     , Gs^Fp       , Hh          , Gg          , Ss          , Hh          , Ch          , 8 Kh        , _off^_usr   , _off^_usr   
_off^_usr   , _off^_usr   , _off^_usr   , Ch          , Gg          , Gg          , Gg          , Wwf         , Ds          , Gg          , Gg          , 5 Hh        , Hh          , Chs         , Ds          , Gg          , Ss          , Gs^Fp       , Ss          , Ch          , _off^_usr   , _off^_usr   
_off^_usr   , _off^_usr   , _off^_usr   , Hh          , Gs^Fp       , Gg          , Ds          , Wwf         , Gg          , Gg          , Gs^Fp       , Gg          , Ds          , Gg          , Ww          , Ww          , Ww          , Ss          , Ss          , Gg          , _off^_usr   , _off^_usr   
_off^_usr   , _off^_usr   , _off^_usr   , Hh          , _off^_usr   , _off^_usr   , _off^_usr   , Ww          , Ss          , Gs^Fp       , Hh          , Gg          , Wwf         , Wwf         , Ds          , Gg          , _off^_usr   , _off^_usr   , _off^_usr   , Ss          , _off^_usr   , _off^_usr   
_off^_usr   , _off^_usr   , _off^_usr   , _off^_usr   , _off^_usr   , _off^_usr   , _off^_usr   , _off^_usr   , _off^_usr   , Ss          , Ww          , Gg          , Ww          , Gg          , _off^_usr   , _off^_usr   , _off^_usr   , _off^_usr   , _off^_usr   , _off^_usr   , _off^_usr   , _off^_usr   
_off^_usr   , _off^_usr   , _off^_usr   , _off^_usr   , _off^_usr   , _off^_usr   , _off^_usr   , _off^_usr   , _off^_usr   , Ss          , Gg          , Ww          , Ww^Bw/      , Gg          , _off^_usr   , _off^_usr   , _off^_usr   , _off^_usr   , _off^_usr   , _off^_usr   , _off^_usr   , _off^_usr   
_off^_usr   , _off^_usr   , _off^_usr   , _off^_usr   , _off^_usr   , _off^_usr   , _off^_usr   , _off^_usr   , Ss          , Gg          , Gg          , Ch          , Ww          , Gg          , Gs^Fp       , _off^_usr   , _off^_usr   , _off^_usr   , _off^_usr   , _off^_usr   , _off^_usr   , _off^_usr   
_off^_usr   , _off^_usr   , _off^_usr   , _off^_usr   , _off^_usr   , _off^_usr   , _off^_usr   , _off^_usr   , Ss          , Gs^Fp       , Ch          , Ch          , Ch          , Hh          , Hh          , _off^_usr   , _off^_usr   , _off^_usr   , _off^_usr   , _off^_usr   , _off^_usr   , _off^_usr   
_off^_usr   , _off^_usr   , _off^_usr   , _off^_usr   , _off^_usr   , _off^_usr   , _off^_usr   , _off^_usr   , _off^_usr   , Hh          , _off^_usr   , 6 Kh        , _off^_usr   , Gg          , _off^_usr   , _off^_usr   , _off^_usr   , _off^_usr   , _off^_usr   , _off^_usr   , _off^_usr   , _off^_usr   
_off^_usr   , _off^_usr   , _off^_usr   , _off^_usr   , _off^_usr   , _off^_usr   , _off^_usr   , _off^_usr   , _off^_usr   , _off^_usr   , _off^_usr   , _off^_usr   , _off^_usr   , _off^_usr   , _off^_usr   , _off^_usr   , _off^_usr   , _off^_usr   , _off^_usr   , _off^_usr   , _off^_usr   , _off^_usr   
_off^_usr   , _off^_usr   , _off^_usr   , _off^_usr   , _off^_usr   , _off^_usr   , _off^_usr   , _off^_usr   , _off^_usr   , _off^_usr   , _off^_usr   , _off^_usr   , _off^_usr   , _off^_usr   , _off^_usr   , _off^_usr   , _off^_usr   , _off^_usr   , _off^_usr   , _off^_usr   , _off^_usr   , _off^_usr   
