Xoc, Qlf, Xoc, Qlf, Xoc, Qlf, Xoc, Qlf, Xoc, Qlf, Xoc, Qlf, Xoc, Qlf, Xoc, Qlf, Xoc, Qlf, Xoc, Qlf, Xoc, Qlf, Xoc, Qlf, Xoc, Qlf, Xoc, Qlf, Xoc, Qlf, Xoc, Qlf, Xoc, Qlf, Xoc, Qlf, Xoc, Qlf, Xoc
Xoc, Xoc, Irs, Xoc, Irs, Xoc, Irs, Xoc, Irs, Xoc, Irs, Xoc, Irs, Xoc, Irs, Xoc, Irs, Xoc, Irs, Xoc, Irs, Xoc, Irs, Xoc, Irs, Xoc, Irs, Xoc, Irs, Xoc, Irs, Xoc, Irs, Xoc, Irs, Xoc, Irs, Xoc, Xoc
Xoc, Irs, Irs, Irs, Irs, Irs, Irs, Irs, Irs, Irs, Irs, Xoc, Irs, Irs, Irs, Irs, Irs, Irs, Irs, Xoc, Irs, Irs, Irs, Irs, Irs, Irs, Irs, Xoc, Irs, Irs, Irs, Irs, Irs, Irs, Irs, Irs, Irs, Irs, Xoc
Xoc, Irs, Xoc, Irs, Xoc, Irs, Irs, Xoc, Xoc, Irs, Xoc, Xoc, Irs, Irs, Xoc, Xoc, Xoc, Xoc, Xoc, Xoc, Xoc, Xoc, Xoc, Xoc, Xoc, Irs, Irs, Xoc, Xoc, Irs, Xoc, Xoc, Irs, Irs, Xoc, Irs, Xoc, Irs, Xoc
Xoc, Xoc, Xoc, Xoc, Xoc, Irs, Irs, Xoc, Xoc, Xoc, Xoc, Xoc, Irs, Irs, Irs, Xoc, Irs, Xoc, Irs, Xoc, Irs, Xoc, Irs, Xoc, Irs, Irs, Irs, Xoc, Xoc, Xoc, Xoc, Xoc, Irs, Irs, Xoc, Xoc, Xoc, Xoc, Xoc
Xoc, Irs, Irs, Irs, Irs, Irs, Irs, Xoc, Irs, Irs, Irs, Xoc, Irs, Irs, Irs, Irs, Irs, Irs, Xoc, Xoc, Xoc, Irs, Irs, Irs, Irs, Irs, Irs, Xoc, Irs, Irs, Irs, Xoc, Irs, Irs, Irs, Irs, Irs, Irs, Xoc
Xoc, Irs, Irs, Irs, Irs, Irs, Irs, Irs, Irs, Irs, Irs, Xoc, Xoc, Xoc, Xoc, Xoc, Xoc, Rr^Pr/, Iwr, Iwr, Iwr, Rr^Pr\, Xoc, Xoc, Xoc, Xoc, Xoc, Xoc, Irs, Irs, Irs, Irs, Irs, Irs, Irs, Irs, Irs, Irs, Xoc
Xoc, Xoc, Xoc, Xoc, Xoc, Xoc, Xoc, Xoc, Xoc, Xoc, Xoc, Xoc, Rrc, Rrc, Rrc, Xoc, Xom, Xoc, Iwr, Iwr, Iwr, Xoc, Xom, Xoc, Rrc, Rrc, Rrc, Xoc, Xoc, Xoc, Xoc, Xoc, Xoc, Xoc, Xoc, Xoc, Xoc, Xoc, Xoc
Xoc, Cud, Cud, Cud, Cud, 6 Kud, Cud, Cud, Cud, Cud, Icn, Rrc, Rrc, Rrc, Xom, Rr^Pw/, Iwr, Xom, Rr^Pw\, Iwr, Rr^Pw/, Xom, Iwr, Rr^Pw\, Xom, Rrc, Rrc, Rrc, Icn, Cud, Cud, Cud, Cud, 7 Kud, Cud, Cud, Cud, Cud, Xoc
Xoc, Icn, Icn, Cud, Cud, Cud, Cud, Cud, Icn, Icn, Xoc, Rrc, Rrc, Rrc, Rrc, Xom, Iwr, Iwr, Xom, Xom, Xom, Iwr, Iwr, Xom, Rrc, Rrc, Rrc, Rrc, Xoc, Icn, Icn, Cud, Cud, Cud, Cud, Cud, Icn, Icn, Xoc
Xoc, Icn, Icn, Icn, Icn, Cud, Icn, Icn, Xoc, Xoc, Rrc, Rrc, Rrc, Rrc, Xom, Xom, Xom, Xom, Xom, Xom, Xom, Xom, Xom, Xom, Xom, Rrc, Rrc, Rrc, Rrc, Xoc, Xoc, Icn, Icn, Cud, Icn, Icn, Icn, Icn, Xoc
Xoc, Icn, Icn, Icn, Icn, Icn, Xoc, Xoc, Rrc, Rrc, Rrc, Rrc, Xom, Xom, Gs^Fds, Gs^Fds, Gs^Fds, Gs^Fds, Gs^Fds, Gs^Fds, Gs^Fds, Gs^Fds, Gs^Fds, Gs^Fds, Gs^Fds, Xom, Xom, Rrc, Rrc, Rrc, Rrc, Xoc, Xoc, Icn, Icn, Icn, Icn, Icn, Xoc
Xoc, Icn, Icn, Icn, Xoc, Xoc, Rrc, Rrc, Rrc, Rrc, Xom, Xom, Gs^Fds, Gs^Fds, Gs^Fds, Gs^Fds, Gs^Fds, Gs^Fds, Gs^Fds, Gs^Fds, Gs^Fds, Gs^Fds, Gs^Fds, Gs^Fds, Gs^Fds, Gs^Fds, Gs^Fds, Xom, Xom, Rrc, Rrc, Rrc, Rrc, Xoc, Xoc, Icn, Icn, Icn, Xoc
Xoc, Icn, Rrc, Xoc, Rrc, Rrc, Rrc, Rrc, Xom, Xom, Gs^Fds, Gs^Fds, Gs^Fds, Gs^Fds, Xue, Xue, Xue, Xue, Xue, Xue, Xue, Xue, Xue, Xue, Xue, Gs^Fds, Gs^Fds, Gs^Fds, Gs^Fds, Xom, Xom, Rrc, Rrc, Rrc, Rrc, Xoc, Rrc, Icn, Xoc
Xoc, Rrc, Rrc, Rrc, Rrc, Rrc, Xom, Xom, Gs^Fds, Gs^Fds, Gs^Fds, Gs^Fds, Xue, Xue, Qxu, Qxu, Qxu, Qxu, Qxu, Qxu, Qxu, Qxu, Qxu, Qxu, Qxu, Xue, Xue, Gs^Fds, Gs^Fds, Gs^Fds, Gs^Fds, Xom, Xom, Rrc, Rrc, Rrc, Rrc, Rrc, Xoc
Xoc, Rrc, Rrc, Rrc, Rrc, Xom, Gs^Fds, Gs^Fds, Gs^Fds, Gs^Fds, Xue, Xue, Qxu, Qxu, Wog^Edb, Wog^Edb, Wog^Edb, Wog^Edb, Wog^Edb, Wog^Edb, Wog^Edb, Wog^Edb, Wog^Edb, Wog^Edb, Wog^Edb, Qxu, Qxu, Xue, Xue, Gs^Fds, Gs^Fds, Gs^Fds, Gs^Fds, Xom, Rrc, Rrc, Rrc, Rrc, Xoc
Xoc, Rrc, Rrc, Xom, Xom, Rrc, Rrc, Gs^Fds, Xue, Xue, Qxu, Qxu, Wog^Edb, Wog^Edb, Wog^Edb, Wog^Edb, Wog^Edb, Wog^Edb, Wog^Edb, Wog^Edb, Wog^Edb, Wog^Edb, Wog^Edb, Wog^Edb, Wog^Edb, Wog^Edb, Wog^Edb, Qxu, Qxu, Xue, Xue, Gs^Fds, Rrc, Rrc, Xom, Xom, Rrc, Rrc, Xoc
Xoc, Rrc, Rrc, Rrc, Rrc, Xom, Ch, Rrc, Rrc, Qxu, Qxu, Wog^Edb, Wog^Edb, Wog^Edb, Wog^Edb, Wog^Edb, Wog^Edb, Wog^Edb, Wog^Edb, Wog^Edb, Wog^Edb, Wog^Edb, Wog^Edb, Wog^Edb, Wog^Edb, Wog^Edb, Wog^Edb, Wog^Edb, Qxu, Qxu, Rrc, Rrc, Ch, Xom, Rrc, Rrc, Rrc, Rrc, Xoc
Xoc, Rrc, Rrc, Xom, Gs^Fds, Rrc, Rrc, Rrc, Irs, Irs, Irs, Qxu, Qxu, Wog^Edb, Wog^Edb, Wog^Edb, Wog^Edb, Wog^Edb, Wog^Edb, Wog^Edb, Wog^Edb, Wog^Edb, Wog^Edb, Wog^Edb, Wog^Edb, Wog^Edb, Qxu, Qxu, Irs, Irs, Irs, Rrc, Rrc, Rrc, Gs^Fds, Xom, Rrc, Rrc, Xoc
Xoc, Rrc, Rrc, Xom, Gs^Fds, Gs^Fds, Xue, Irs, Irs, Irs, Irs, Irs, Irs, Qxu, Qxu, Wog^Edb, Wog^Edb, Wog^Edb, Cm, Cm, Cm, Wog^Edb, Wog^Edb, Wog^Edb, Qxu, Qxu, Irs, Irs, Irs, Irs, Irs, Irs, Xue, Gs^Fds, Gs^Fds, Xom, Rrc, Rrc, Xoc
Xoc, Rrc, Rrc, Xom, Gs^Fds, Gs^Fds, Xue, Qxu, Qxu, Irs, Irs, Irs, Irs, Irs, Irs, Rrc, Cm, Cm, Xoc, Cm, Xoc, Cm, Cm, Rrc, Irs, Irs, Irs, Irs, Irs, Irs, Qxu, Qxu, Xue, Gs^Fds, Gs^Fds, Xom, Rrc, Rrc, Xoc
Xoc, Rrc, Rrc, Xom, Gs^Fds, Gs^Fds, Xue, Qxu, Wwrg^Edb, Qxu, Qxu, Irs, Irs, Irs, Xoc, Irs, Irs, Xoc, Xoc, Cm, Xoc, Xoc, Irs, Irs, Xoc, Irs, Irs, Irs, Qxu, Qxu, Wwrg^Edb, Qxu, Xue, Gs^Fds, Gs^Fds, Xom, Rrc, Rrc, Xoc
Xoc, Rrc, Rrc, Xom, Gs^Fds, Gs^Fds, Xue, Qxu, Wwrg^Edb, Wwrg^Edb, Wwrg^Edb, Qxu, Qxu, Irs, Irs, Xoc, Xoc, Irs, Irs, Cm, Irs, Irs, Xoc, Xoc, Irs, Irs, Qxu, Qxu, Wwrg^Edb, Wwrg^Edb, Wwrg^Edb, Qxu, Xue, Gs^Fds, Gs^Fds, Xom, Rrc, Rrc, Xoc
Xoc, Rrc, Rrc, Xom, Gs^Fds, Gs^Fds, Xue, Qxu, Wwrg^Edb, Wwrg^Edb, Wwrg^Edb, Wwrg^Edb, Wwrg^Edb, Rrc, Xoc, Irs, Irs, Irs, 2 Km, 1 Km, 5 Km, Irs, Irs, Irs, Xoc, Rrc, Wwrg^Edb, Wwrg^Edb, Wwrg^Edb, Wwrg^Edb, Wwrg^Edb, Qxu, Xue, Gs^Fds, Gs^Fds, Xom, Rrc, Rrc, Xoc
Xoc, Rrc, Rrc, Xom, Gs^Fds, Gs^Fds, Xue, Qxu, Wwrg^Edb, Wwrg^Edb, Wwrg^Edb, Wwrg^Edb, Wwrg^Edb, Wwrg^Edb, Xoc, Irs, Irs, Irs, 3 Km, Cm, 4 Km, Irs, Irs, Irs, Xoc, Wwrg^Edb, Wwrg^Edb, Wwrg^Edb, Wwrg^Edb, Wwrg^Edb, Wwrg^Edb, Qxu, Xue, Gs^Fds, Gs^Fds, Xom, Rrc, Rrc, Xoc
Xoc, Rrc, Rrc, Xom, Gs^Fds, Gs^Fds, Xue, Qxu, Wwrg^Edb, Wwrg^Edb, Wwrg^Edb, Wwrg^Edb, Qxu, Rrc, Irs, Irs, Xoc, Irs, Irs, Cm^Ebn, Irs, Irs, Xoc, Irs, Irs, Rrc, Qxu, Wwrg^Edb, Wwrg^Edb, Wwrg^Edb, Wwrg^Edb, Qxu, Xue, Gs^Fds, Gs^Fds, Xom, Rrc, Rrc, Xoc
Xoc, Rrc, Rrc, Xom, Gs^Fds, Gs^Fds, Xue, Qxu, Wwrg^Edb, Wwrg^Edb, Qxu, Qxu, Irs, Irs, Xoc, Xoc, Irs, Irs, Xoc, Cm, Xoc, Irs, Irs, Xoc, Xoc, Irs, Irs, Qxu, Qxu, Wwrg^Edb, Wwrg^Edb, Qxu, Xue, Gs^Fds, Gs^Fds, Xom, Rrc, Rrc, Xoc
Xoc, Rrc, Rrc, Xom, Gs^Fds, Gs^Fds, Xue, Qxu, Qxu, Qxu, Irs, Irs, Irs, Irs, Irs, Irs, Cm, Xoc, Xoc, Cm, Xoc, Xoc, Cm, Irs, Irs, Irs, Irs, Irs, Irs, Qxu, Qxu, Qxu, Xue, Gs^Fds, Gs^Fds, Xom, Rrc, Rrc, Xoc
Xoc, Rrc, Rrc, Xom, Gs^Fds, Gs^Fds, Xue, Qxu, Irs, Irs, Irs, Irs, Irs, Irs, Qxu, Rrc, Wog^Edb, Cm, Cm, Cm, Cm, Cm, Wog^Edb, Rrc, Qxu, Irs, Irs, Irs, Irs, Irs, Irs, Qxu, Xue, Gs^Fds, Gs^Fds, Xom, Rrc, Rrc, Xoc
Xoc, Rrc, Rrc, Xom, Gs^Fds, Gs^Fds, Rrc, Irs, Irs, Irs, Irs, Irs, Qxu, Qxu, Wog^Edb, Wog^Edb, Wog^Edb, Wog^Edb, Wog^Edb, Cm, Wog^Edb, Wog^Edb, Wog^Edb, Wog^Edb, Wog^Edb, Qxu, Qxu, Irs, Irs, Irs, Irs, Irs, Rrc, Gs^Fds, Gs^Fds, Xom, Rrc, Rrc, Xoc
Xoc, Rrc, Rrc, Xom, Rrc, Rrc, Ch, Rrc, Rrc, Irs, Qxu, Qxu, Wog^Edb, Wog^Edb, Wog^Edb, Wog^Edb, Wog^Edb, Wog^Edb, Wog^Edb, Wog^Edb, Wog^Edb, Wog^Edb, Wog^Edb, Wog^Edb, Wog^Edb, Wog^Edb, Wog^Edb, Qxu, Qxu, Irs, Rrc, Rrc, Ch, Rrc, Rrc, Xom, Rrc, Rrc, Xoc
Xoc, Rrc, Rrc, Rrc, Xom, Xom, Rrc, Rrc, Xue, Qxu, Qxu, Wog^Edb, Wog^Edb, Wog^Edb, Wog^Edb, Wog^Edb, Wog^Edb, Wog^Edb, Wog^Edb, Wog^Edb, Wog^Edb, Wog^Edb, Wog^Edb, Wog^Edb, Wog^Edb, Wog^Edb, Wog^Edb, Wog^Edb, Qxu, Qxu, Xue, Rrc, Rrc, Xom, Xom, Rrc, Rrc, Rrc, Xoc
Xoc, Rrc, Rrc, Xom, Rrc, Rrc, Gs^Fds, Gs^Fds, Gs^Fds, Xue, Xue, Qxu, Qxu, Wog^Edb, Wog^Edb, Wog^Edb, Wog^Edb, Wog^Edb, Wog^Edb, Wog^Edb, Wog^Edb, Wog^Edb, Wog^Edb, Wot, Wog^Edb, Wog^Edb, Qxu, Qxu, Xue, Xue, Gs^Fds, Gs^Fds, Gs^Fds, Rrc, Rrc, Xom, Rrc, Rrc, Xoc
Xoc, Rrc, Rrc, Rrc, Rrc, Xom, Xom, Gs^Fds, Gs^Fds, Gs^Fds, Gs^Fds, Xue, Xue, Qxu, Qxu, Wog^Edb, Qxu, Wog^Edb, Qxu, Wog^Edb, Qxu, Wog^Edb, Qxu, Wog^Edb, Qxu, Qxu, Xue, Xue, Gs^Fds, Gs^Fds, Gs^Fds, Gs^Fds, Xom, Xom, Rrc, Rrc, Rrc, Rrc, Xoc
Xoc, Rrc, Rrc, Rrc, Rrc, Rrc, Rrc, Xom, Xom, Gs^Fds, Gs^Fds, Gs^Fds, Gs^Fds, Xue, Xue, Qxu, Xue, Qxu, Xue, Qxu, Xue, Qxu, Xue, Qxu, Xue, Xue, Gs^Fds, Gs^Fds, Gs^Fds, Gs^Fds, Xom, Xom, Rrc, Rrc, Rrc, Rrc, Rrc, Rrc, Xoc
Xoc, Icn, Icn, Xoc, Xoc, Rrc, Rrc, Rrc, Rrc, Xom, Xom, Gs^Fds, Gs^Ft, Gs^Fds, Gs^Fds, Xue, Gs^Fds, Xue, Gs^Fds, Xue, Gs^Fds, Xue, Gs^Fds, Xue, Gs^Fds, Gs^Fds, Gs^Fds, Gs^Fds, Xom, Xom, Rrc, Rrc, Rrc, Rrc, Xoc, Xoc, Icn, Icn, Xoc
Xoc, Icn, Icn, Icn, Icn, Xoc, Xoc, Rrc, Rrc, Rrc, Rrc, Xom, Xom, Gs^Fds, Gs^Fds, Gs^Fds, Gs^Fds, Gs^Fds, Gs^Fds, Gs^Fds, Gs^Fds, Gs^Fds, Gs^Fds, Gs^Fds, Gs^Fds, Gs^Fds, Xom, Xom, Rrc, Rrc, Rrc, Rrc, Xoc, Xoc, Icn, Icn, Icn, Icn, Xoc
Xoc, Icn, Icn, Icn, Icn, Icn, Icn, Xoc, Xoc, Rrc, Rrc, Rrc, Rrc, Xom, Xom, Gs^Fds, Xom, Gs^Fds, Xom, Gs^Fds, Xom, Gs^Fds, Xom, Gs^Fds, Xom, Xom, Rrc, Rrc, Rrc, Rrc, Xoc, Xoc, Icn, Icn, Icn, Icn, Icn, Icn, Xoc
Xoc, Icn, Icn, Icn, Cud, Cud, Cud, Icn, Icn, Xoc, Xoc, Rrc, Rrc, Rrc, Rrc, Xom, Iwr, Xom, Xom, Xom, Xom, Xom, Iwr, Xom, Rrc, Rrc, Rrc, Rrc, Xoc, Xoc, Icn, Icn, Cud, Cud, Cud, Icn, Icn, Icn, Xoc
Xoc, Icn, Cud, Cud, Cud, Cud, Cud, Cud, Cud, Icn, Icn, Rrc, Rrc, Rrc, Xom, Xom, Iwr, Iwr, Rr^Pw/, Xom, Rr^Pw\, Iwr, Iwr, Xom, Xom, Rrc, Rrc, Rrc, Icn, Icn, Cud, Cud, Cud, Cud, Cud, Cud, Cud, Icn, Xoc
Xoc, Cud, Xoc, Cud, Xoc, 9 Kud, Xoc, Cud, Xoc, Cud, Xoc, Rrc, Rrc, Rrc, Rrc, Rr^Pw\, Xom, Xom, Iwr, Iwr, Iwr, Xom, Xom, Rr^Pw/, Rrc, Rrc, Rrc, Rrc, Xoc, Cud, Xoc, Cud, Xoc, 8 Kud, Xoc, Cud, Xoc, Cud, Xoc
Xoc, Xoc, Irs, Xoc, Irs, Xoc, Irs, Xoc, Irs, Xoc, Irs, Xoc, Xoc, Rrc, Xoc, Xoc, Xoc, Xoc, Iwr, Iwr, Iwr, Xoc, Xoc, Xoc, Xoc, Rrc, Xoc, Xoc, Irs, Xoc, Irs, Xoc, Irs, Xoc, Irs, Xoc, Irs, Xoc, Xoc
Xoc, Irs, Irs, Irs, Irs, Irs, Irs, Irs, Irs, Irs, Irs, Xoc, Irs, Xoc, Irs, Xoc, Irs, Rr^Pr\, Xoc, Iwr, Xoc, Rr^Pr/, Irs, Xoc, Irs, Xoc, Irs, Xoc, Irs, Irs, Irs, Irs, Irs, Irs, Irs, Irs, Irs, Irs, Xoc
Xoc, Irs, Xoc, Irs, Xoc, Irs, Irs, Xoc, Xoc, Irs, Xoc, Xoc, Irs, Irs, Irs, Irs, Irs, Irs, Irs, Xoc, Irs, Irs, Irs, Irs, Irs, Irs, Irs, Xoc, Xoc, Irs, Xoc, Xoc, Irs, Irs, Xoc, Irs, Xoc, Irs, Xoc
Xoc, Xoc, Xoc, Xoc, Xoc, Irs, Irs, Xoc, Xoc, Xoc, Xoc, Xoc, Irs, Irs, Xoc, Xoc, Xoc, Xoc, Xoc, Xoc, Xoc, Xoc, Xoc, Xoc, Xoc, Irs, Irs, Xoc, Xoc, Xoc, Xoc, Xoc, Irs, Irs, Xoc, Xoc, Xoc, Xoc, Xoc
Xoc, Irs, Irs, Irs, Irs, Irs, Irs, Xoc, Irs, Irs, Irs, Xoc, Irs, Irs, Irs, Xoc, Irs, Xoc, Irs, Xoc, Irs, Xoc, Irs, Xoc, Irs, Irs, Irs, Xoc, Irs, Irs, Irs, Xoc, Irs, Irs, Irs, Irs, Irs, Irs, Xoc
Xoc, Irs, Irs, Irs, Irs, Irs, Irs, Irs, Irs, Irs, Irs, Xoc, Irs, Irs, Irs, Irs, Irs, Irs, Irs, Xoc, Irs, Irs, Irs, Irs, Irs, Irs, Irs, Xoc, Irs, Irs, Irs, Irs, Irs, Irs, Irs, Irs, Irs, Irs, Xoc
Xoc, Xoc, Xoc, Xoc, Xoc, Xoc, Xoc, Xoc, Xoc, Xoc, Xoc, Xoc, Xoc, Xoc, Xoc, Xoc, Xoc, Xoc, Xoc, Xoc, Xoc, Xoc, Xoc, Xoc, Xoc, Xoc, Xoc, Xoc, Xoc, Xoc, Xoc, Xoc, Xoc, Xoc, Xoc, Xoc, Xoc, Xoc, Xoc
