border_size=1
usage=map

Xu, Xu, Xu, Xu, Xu, Xu, Xu, Xu, Xu, Xu, Xu, Xu, Mm, Mm, Mm, Gg, Gs^Fp, Hh, Hh, Gg, Gg, Gg, Gg, Gg, Gg, Gg, Gg, Gg, Gg, Gg, Ch, Gg, Ch, Gg, Hh, Hh, Mm, Mm^Xm, Mm^Xm, Hh, Hh, Hh, Wo, Wo, Ww^Ewl, Aa, Ww^Ewl, Wo, Ww^Ewf, Wo, Wo, Gg, Gg, Hh, Ms, Ms, Ha, Ha, Gs^Fp, Gg, Gs^Fp, Gs^Fp, Gs^Fp, Gs^Fp, Gg, Gg, Gg, Gg, Aa^Fpa, Aa^Fpa, Aa^Fpa, Aa, Aa, Ds, Mm^Xm, Mm, Mm, Mm, Mm, Mm, Mm, Mm, Mm, Mm
Xu, Xu, Qxu, Uu, Qxu, Xu, Xu, Xu, Xu, Xu, Uu, Re, Re, Re, Re, Re, Re, Hh, Re, Gg, Re, Gs^Fp, Gg, Gg, Gg, Gg, Gg, Gg, Gg, Gg, Ch, Ch, Ch, Kh, Hh, Mm, Mm^Xm, Mm^Xm, Mm, Hh, Gs^Fp, Gg, Wo, Ww^Ewl, Ww^Ewl, Ww^Ewf, Ww^Ewl, Ww^Ewl, Wo, Ww^Ewl, Wo, Gg, Gg, Aa^Fpa, Ha, Ha, Aa^Fpa, Aa^Fpa, Gs^Fp, Aa^Fpa, Gs^Fp, Aa^Fpa, Gs^Fp, Aa^Fpa, Gll^Fp, Gg, Gg, Aa, Aa^Fpa, Aa, Aa, Aa^Fpa, Aa, Mm^Xm, Mm^Xm, Mm^Xm, Mm^Xm, Mm^Xm, Mm^Xm, Mm^Xm, Mm^Xm, Mm^Xm, Mm^Xm, Mm
Xu, Uu, Uu, Uu, Wwr, Qxu, Xu, Xu, Uu, Uu, Xu, Mm, Mm, Mm, Mm, Mm, Mm, Re, Hh, Re, Gg, Re, Re, Re, Re, Gg, Gg, Gg, Gg, Gg, Rd, Ch, Ch, Ch, Hh, Mm, Mm^Xm, Mm^Xm, Hh, Gs^Fp, Gs^Fp, Gg, Gg, Wo, Ww^Ewf, Ww^Ewl, Wo, Wo, Gg, Wo, Gg, Gs^Fp, Gs^Fp, Aa^Fpa, Aa^Fpa, Aa^Fpa, Gs^Fp, Gs^Fp, Gs^Fp, Gs^Fp, Gs^Fp, Gs^Fp, Gs^Fp, Gs^Fp, Gs^Fp, Gg, Gg, Aa, Aa, Aa^Fpa, Aa^Fpa, Aa^Fpa, Aa, Mm^Xm, Uu^Uf, Uu, Uu, Uu, Uu, Uu, Uu, Uu, Mm, Mm
Xu, Qxu, Wwr, Ww, Uu, Qxu, Xu, Xu, Xu, Uu, Xu, Mm, Mm, Mm, Mm, Mm, Mm, Mm, Hh, Hh, Hh, Hh, Hh, Hh, Gg, Re, Rd, Rd, Rd, Rd, Gg, Ch, Ch, Hh, Mm, Mm^Xm, Hh, Hh, Gs^Fp, Gs^Fp, Gs^Fp, Gs^Fp, Wo, Wo, Ww^Ewl, Ww^Ewl, Wo, Gg, Gs^Fp, Gs^Fp, Gs^Fp, Gll^Fp, Gs^Fp, Gs^Fp, Gs^Fp, Gs^Fp, Gs^Fp, Gs^Fp, Ch, Ch, Ch, Gs^Fp, Gs^Fp, Gs^Fp, Gs^Fp, Aa^Fpa, Gg, Gg, Aa, Aa^Fpa, Aa^Fpa, Aa, Aa, Mm^Xm, Mm^Xm, Mm, Uu, Mm^Xm, Mm^Xm, Mm^Xm, Mm^Xm, Uu, Mm, Mm
Xu, Qxu, Qxu, Uu, Uu, Uu, Xu, Xu, Xu, Uu, Uu, Xu, Xu, Mm, Mm, Mm, Mm, Mm, Hh, Hh, Hh, Hh, Hh, Hh, Hh, Hh, Rd, Hh, Gg, Gg, Rd, Rd, Hh, Mm, Mm^Xm, Mm^Xm, Hh, Gs^Fp, Ww, Ww, Wwr, Wwr, Wo, Ww^Ewf, Ww^Ewl, Ww^Ewf, Wo, Hh, Gs^Fp, Gg, Gs^Fp, Gs^Fp, Gs^Fp, Gg, Gs^Fp, Gs^Fp, Gs^Fp, Gs^Fp, Ch, 7 Kh, Ch, Gs^Fp, Gs^Fp, Gs^Fp, Gs^Fp, Gs^Fp, Rp, Rp, Rp, Rp, Rp, Rp, Rp, Uu, Mm^Xm, Mm^Xm, Uu, Mm^Xm, Mm, Mm, Mm, Uu, Mm, Mm
Xu, Xu, Xu, Uu, Xu, Gg^Fet, Uu, Xu, Xu, Xu, Xu, Uu, Xu, Mm, Mm, Mm, Mm, Mm, Gs^Fp, Ww, Hh, Hh, Hh, Hh, Hh, Hh, Rd, Gs^Fp, Gs^Fp, Gg, Rd, Hh, Mm, Mm, Mm^Xm, Mm^Xm, Hh, Gs^Fp, Ww, Wo, Wo, Wwr, Wwr, Wo, Wo, Wo, Gg, Gg, Gs^Fp, Gs^Fp, Gg, Gs^Fp, Gs^Fp, Gs^Fp, Gs^Fp, Gs^Fp, Gs^Fp, Ch, Ch, Ch, Gs^Fp, Rp, Gs^Fp, Gll^Fp, Gs^Fp, Gs^Fp, Rp, Aa, Aa, Aa, Aa, Aa, Ha, Mm^Xm, Mm, Mm^Xm, Uh, Mm^Xm, Mm^Xm, Mm, Mm^Xm, Uu, Mm^Xm, Mm^Xm
Xu, Xu, Xu, Xu, Xu, Xu, Uu, Xu, Xu, Xu, Xu, Uu, Xu, Mm, Mm, Mm, Mm, Mm, Gs^Fp, Hh, Hh, Hh, Hh, Hh, Hh, Gs^Fp, Rd, Gs^Fp, Gg, Gg, Rd, Gg, Hh, Hh, Mm, Mm^Xm, Mm, Gs^Fp, Ww, Wo, Ww^Ewl, Wo, Wwr, Wwr, Wo, Wo, Wo, Gg, Gs^Fp, Gs^Fp, Gs^Fp, Gs^Fp, Gs^Fp, Gs^Fp, Gs^Fp, Gs^Fp, Gs^Fp, Gs^Fp, Gs^Fp, Gs^Fp, Gs^Fp, Rp, Rp, Gs^Fp, Rp, Rp, Gg, Aa^Fpa, Aa^Fpa, Aa, Aa, Ha, Ha, Mm, Mm, Mm^Xm, Uh, Uh, Uu, Mm^Xm, Uu, Uu, Mm^Xm, Mm^Xm
Xu, Xu, Xu, Xu, Cud, Xu, Xu, Uu, Uu, Xu, Xu, Uu, Xu, Mm, Mm, Mm, Mm, Mm, Gg, Gg, Gg, Gg, Gg, Gg, Gg, Gs^Fp, Rd, Gs^Fp, Gg, Gg, Rd, Gg, Gg, Hh, Mm, Mm^Xm, Mm, Ww, Wo, Wo, Ww^Ewf, Wo, Wo, Wwr, Wwr, Wo, Wo, Gg, Gg, Gg, Gll^Fp, Gs^Fp, Gs^Fp, Gs^Fp, Gs^Fp, Gll^Fp, Gs^Fp, Gs^Fp, Gs^Fp, Gs^Fp, Hh, Gs^Fp, Hh, Rp, Gs^Fp, Gll^Fp, Gg, Aa, Aa, Aa^Fpa, Aa^Fpa, Aa^Fpa, Aa^Fpa, Mm, Mm, Mm^Xm, Uu, Mm^Xm, Uu, Mm^Xm, Uu, Mm^Xm, Mm^Xm, Mm^Xm
Xu, Xu, Cud, Cud, Cud, Cud, Cud, Xu, Uu, Xu, Xu, Uu, Xu, Mm, Mm, Mm, Mm, Mm, Gg, Gg, Gg, Gg, Gg, Gg, Gg, Gs^Fp, Rd, Gg, Xv, Xv, Rp, Xv, Xv, Gg, Mm, Mm^Xm, Mm, Ww, Wo, Ww^Ewf, Wo, Wo, Ww, Wwr, Gg, Ww, Ww, Gg, Gll^Fp, Gg, Gll^Fp, Gll^Fp, Gll^Fp, Gg, Gll^Fp, Gg, Gg, Gs^Fp, Gs^Fp, Hh, Hh, Gs^Fp, Gs^Fp, Rp, Gll^Fp, Gll^Fp, Gg, Aa, Aa, Aa^Fpa, Gll^Fp, Gll^Fp, Gll^Fp, Mm, Mm, Mm^Xm, Uu, Mm^Xm, Uu, Mm^Xm, Uu, Mm^Xm, Mm^Xm, Mm^Xm
Xu, Xu, Cud, Cud, 9 Kud, Cud, Cud, Xu, Uu, Xu, Xu, Uu, Xu, Mm, Mm, Mm, Mm, Gg, Gg, Gg, Gg, Gg, Gg, Gg, Gs^Fp, Gs^Fp, Gg, Rd, Xv, Rp, Ww, Rp, Xv, Gg, Mm, Mm^Xm, Mm^Xm, Ww, Ww, Wo, Wo, Ww, Gg, Gs^Fp, Gg, Gg, Ww, Gg, Gg, Gg, Gg, Gll^Fp, Gll^Fp, Gll^Fp, Hh, Gll^Fp, Gll^Fp, Gll^Fp, Gs^Fp, Gs^Fp, Hh, Hh, Gs^Fp, Rp, Gll^Fp, Hh, Ha, Aa, Aa^Fpa, Aa^Fpa, Gll^Fp, Gs^Fp, Gs^Fp, Mm, Mm, Mm^Xm, Uu, Mm^Xm, Uu, Mm^Xm, Uu, Uu, Mm^Xm, Mm^Xm
Xu, Xu, Cud, Cud, Cud, Cud, Cud, Xu, Uu, Xu, Xu, Uu, Xu, Mm, Mm, Mm, Mm, Mm, Mm, Gg, Gs^Fp, Gs^Fp, Gs^Fp, Gs^Fp, Gg, Gg, Gg, Rd, Rd, Rp, Rp, Rp, Xv, Gg, Gg, Mm, Mm^Xm, Mm, Ss, Ww, Wo, Ww, Gg, Gg, Gg, Gg, Gg, Ww, Gg, Gg, Gg, Gg, Gg, Hh, Gg, Hh, Gs, Gll^Fp, Gll^Fp, Gs^Fp, Gs^Fp, Gs^Fp, Gs^Fp, Rp, Gll^Fp, Hh, Aa^Fpa, Aa, Aa^Fpa, Gll^Fp, Gs^Fp, Gs^Fp, Gs^Fp, Mm, Mm, Mm^Xm, Uu, Mm^Xm, Uu, Mm^Xm, Mm^Xm, Uu, Uu, Mm^Xm
Xu, Xu, Xu, Cud, Uu, Uu, Xu, Xu, Uu, Xu, Xu, Uu, Xu, Mm, Mm, Mm, Mm, Mm, Mm, Gs^Fp, Gs^Fp, Gg, Gs^Fp, Gs^Fp, Gs^Fp, Gg, Gg, Gg, Rd, Xv, Xv, Xv, Gg, Gg, Gg, Gg, Mm^Xm, Mm, Gs^Fp, Ww, Ww, Ww, Ds, Gg, Gg, Gg, Gg, Ww, Ww, Gs^Fp, Gs^Fp, Gg, Gg, Gg, Gg, Gs, Ds, Gg, Gg, Gll^Fp, Gg, Gll^Fp, Gg, Rp, Gs^Fp, Gll^Fp, Aa^Fpa, Aa, Aa^Fpa, Gll^Fp, Gs^Fp, Gs^Fp, Gs^Fp, Mm, Mm^Xm, Mm^Xm, Uu, Mm^Xm, Mm^Xm, Uu, Uu, Uh, Mm^Xm, Mm^Xm
Xu, Xu, Uh, Xu, Uu, Uu, Uh, Xu, Xu, Uu, Uu, Uu, Xu, Xu, Mm, Mm, Mm, Mm, Mm, Ss, Ss, Gg, Gg, Gg, Gs^Fp, Gs^Fp, Gg, Rd, Gg, Gg, Gg, Gg, Gg, Gg, Gg, Gg, Mm, Mm^Xm, Mm^Xm, Gs^Fp, Gs^Fp, Gs^Fp, Gs^Fp, Gs^Fp, Gg, Gg, Gg, Ww, Ww, Gs^Fp, Wo, Gs^Fp, Ww, Ww, Ww, Ds, Wo, Ww, Ds, Gs, Gg, Gg, Gg, Rp, Gs^Fp, Gg, Gll^Fp, Aa^Fpa, Hh, Gll^Fp, Gg, Gg, Gg, Mm, Mm^Xm, Mm^Xm, Uu, Mm^Xm, Mm^Xm, Mm^Xm, Mm^Xm, Uh, Uh, Mm^Xm
Xu, Uh, Uh, Xu, Xu, Uh, Uu, Uu, Uu, Xu, Xu, Xu, Xu, Mm, Mm, Mm, Mm, Mm, Ss, Ss, Ss, Ss, Gg, Gg, Gs^Fp, Gs^Fp, Gg, Rd, Gg, Gg, Gg, Gg, Gg, Gg, Gs^Fp, Gs^Fp, Gs^Fp, Mm, Mm, Mm^Xm, Mm, Gs^Fp, Gs^Fp, Gg, Gg, Gg, Gg, Ww, Wo, Wo, Wo, Gs^Fp, Re, Re, Ww^Bw\, Ww, Ds, Ds, Gs, Gs, Gg, Gg, Gg, Rp, Gg, Gg, Gg, Gg, Gg, Gg, Gg, Gg, Gg, Mm, Mm^Xm, Mm^Xm, Uu, Uu, Uu^Uf, Mm^Xm, Mm^Xm, Mm^Xm, Mm^Xm, Mm^Xm
Xu, Uh, Xu, Uh, Uh, Xu, Xu, Uu, Uu, Uu, Uu, Uu, Mm, Mm, Mm, Mm, Mm, Ss, Ss, Gs^Fp, Ss, Ds, Ss, Gs^Fp, Gs^Fp, Gs^Fp, Gg, Rd, Gg, Gs^Fp, Gs^Fp, Gs^Fp, Gs^Fp, Gs^Fp, Gs^Fp, Gs^Fp, Gs^Fp, Gg, Gg, Mm^Xm, Mm^Xm, Mm, Mm, Gs^Fp, Gs^Fp, Gg, Wwg, Wo, Wo, Wo, Chw, Wo, Ww, Gs, Ww, Re, Re, Gg, Re, Gg, Re, Gg, Re, Re, Re, Gg, Gg, Gg, Gg, Gg, Gg, Gg, Gg, Mm, Mm, Mm^Xm, Uu, Mm^Xm, Mm^Xm, Uu, Uu, Mm^Xm, Mm^Xm, Mm^Xm
Xu, Xu, Xu, Xu, Xu, Uu, Uu, Uu, Xu, Uu, Wwf, Uu, Re, Mm, Mm, Mm, Mm, Gs^Fp, Gs^Fp, Gs^Fp, Ds, Ds, Gs^Fp, Gs^Fp, Gs^Fp, Gs^Fp, Gs^Fp, Rd, Gs^Fp, Gs^Fp, Ss, Gs^Fp, Gg, Gs^Fp, Gs^Fp, Gs^Fp, Gs^Fp, Gs^Fp, Gg, Gg, Gg, Mm^Xm, Mm^Xm, Mm, Gs^Fp, Gg, Ww, Wo, Chw, 8 Khw, Chw, Wo, Ww, Ds, Ww, Gs, Gs, Re, Ds, Re, Gg, Re, Gg, Gg, Gg, Re, Gs, Gs, Gs, Gg, Gg, Gg, Gg, Mm, Mm, Mm^Xm, Uu, Mm^Xm, Mm, Mm^Xm, Mm^Xm, Uu, Uu, Mm
Xu, Xu, Xu, Xu, Xu, Xu, Xu, Uu, Xu, Xu, Mm, Mm, Mm, Re, Re, Mm, Gs^Fp, Gs^Fp, Gs^Fp, Gg, Gs^Fp, Gs^Fp, Gs^Fp, Gs^Fp, Gs^Fp, Gs^Fp, Rd, Rd, Gs^Fp, Ss, Ss, Gs^Fp, Gs^Fp, Gs^Fp, Gs^Fp, Gs^Fp, Gs^Fp, Gs^Fp, Gg, Ha, Hh, Mm, Mm^Xm, Hh, Gg, Gg, Ww, Wo, Wo, Chw, Wo, Wo, Ww, Ds, Ds, Ww, Ss, Ss, Ds, Ss, Ss, Ss, Ss, Gg, Rb, Rb, Dd, Dd, Dd, Gs, Gs, Gg, Gg, Hh, Mm, Mm^Xm, Uu, Mm^Xm, Mm, Mm^Xm, Uu, Uu, Uu, Mm
Xu, Xu, Xu, Xu, Xu, Xu, Xu, Uu, Xu, Mm, Mm, Mm, Mm, Mm, Re, Gg, Gs^Fp, Gg, Gg, Gg, Gg, Gg, Gs^Fp, Gs^Fp, Gs^Fp, Gs^Fp, Rd, Gs^Fp, Ds, Ds, Ds, Gs^Fp, Gs^Fp, Gs^Fp, Gs^Fp, Gg, Gg, Gs^Fp, Gg, Ha, Hh, Mm, Mm^Xm, Hh, Gg, Gg, Aa, Ww, Ww, Wo, Ww, Ww, Ss, Ds, Ds, Ww, Ss, Ds, Ds, Ds, Ds, Ds, Ss, Rb, Dd, Dd^Ftd, Dd^Ftd, Dd^Ftd, Dd^Ftd, Dd, Dd, Gs, Gg, Hh, Ms, Mm^Xm, Uu, Mm^Xm, Mm^Xm, Mm^Xm, Uu, Mm^Xm, Uu, Mm
Xu, Xu, Uu, Uu, Uu, Xu, Uu, Uu, Uh, Xu, Xu, Xu, Xu, Mm, Re, Gg, Re, Re, Re, Gg, Re, Gg, Gg, Gg, Rd, Rd, Gg, Gs^Fp, Ds, Ds, Gs^Fp, Gs^Fp, Gs^Fp, Gs^Fp, Gg, Gg, Gg, Hh, Hh, Hh, Mm, Mm, Mm^Xm, Hh, Hh, Aa, Aa^Fpa, Aa, Gg, Ww, Ds, Ds, Ds, Ss, Ss, Ss, Ss, Ss, Ds, Ds, Ds, Dd, Ss, Ss^Bw|r, Ss, Dd^Ftd, Dd^Ftd, Dd^Ftd, Dd^Ftd, Dd^Ftd, Dd, Hhd, Hh, Hh, Ms, Mm^Xm, Uu, Mm^Xm, Mm^Xm, Uu, Uu, Mm^Xm, Uu, Mm
Xu, Xu, Uu, Uu, Gg^Fet, Uu, Xu, Xu, Xu, Uh, Xu, Xu, Xu, Mm, Hh, Re, Mm, Hh, Hh, Re, Mm, Re, Re, Rd, Gg, Gg, Gg, Gg, Ds, Gg, Gg, Gg, Gs^Fp, Gs^Fp, Gg, Gg, Gg, Hh, Hh, Mm, Mm^Xm, Mm^Xm, Mm, Hh, Ha, Aa, Aa^Fpa, Aa, Gg, Gs, Ds, Ww, Ww, Ss, Ss, Ss, Ss, Ss, Ss, Ss, Ss, Dd, Ds, Rb, Ds, Ss, Ss, Dd^Ftd, Dd^Ftd, Dd^Ftd, Dd, Hhd, Hh, Aa^Fpa, Ms, Mm^Xm, Uu, Mm^Xm, Mm^Xm, Uu, Uu, Mm^Xm, Uu, Mm
Xu, Xu, Xu, Uu, Uu, Uu, Xu, Xu, Uu, Uu, Uu, Xu, Xu, Xu, Uu, Mm, Xu, Mm, Mm, Mm, Mm, Mm, Hh, Re, Re, Gg, Re, Re, Re, Gg, Gg, Gg, Gg, Gs^Fp, Gg, Gg, Mm^Xm, Hh, Mm^Xm, Mm^Xm, Mm, Mm^Xm, Mm, Ha, Aa, Gg, Gg, Aa, Gg, Gs, Ds, Ww, Ds, Ds, Ds, Ss, Ds, Ss, Ds, Ss, Ds, Ds, Ds, Rb, Ds, Ss, Ss, Dd^Ftd, Dd^Ftd, Dd^Ftd, Dd, Hhd, Hh, Aa^Fpa, Mm, Mm^Xm, Uu, Mm^Xm, Uu, Mm^Xm, Mm^Xm, Mm^Xm, Uu, Mm
Xu, Xu, Xu, Xu, Xu, Xu, Uu, Uu, Uu, Uu, Xu, Xu, Xu, Xu, Uu, Xu, Xu, Xu, Xu, Xu, Xu, Mm, Mm, Mm, Hh, Re, Hh, Hh, Hh, Re, Re, Gg, Gg, Gs^Fp, Mm^Xm, Mm^Xm, Hh, Mm^Xm, Hh, Mm, Mm, Mm, Hh, Ha, Aa, Gg, Gg, Gg, Gg, Gs, Dd, Ds, Dd, Dd, Dd^Do, Ds, Dd, Dd, Dd, Ds, Dd, Ds, Rb, Rb, Dd^Ftd, Ss, Dd^Ftd, Dd^Ftd, Dd^Ftd, Dd, Dd, Hhd, Hh, Hh, Mm, Mm^Xm, Uu, Uu, Uu, Uu^Uf, Uu^Uf, Mm^Xm, Uh, Mm
Xu, Xu, Xu, Xu, Xu, Uu, Uu, Xu, Xu, Xu, Xu, Xu, Xu, Xu, Xu, Uu, Uh, Xu, Xu, Xu, Xu, Xu, Xu, Mm, Mm, Mm, Mm, Hh, Mm, Hh, Mm, Re, Re, Mm^Xm, Hh, Gs^Fp, Hh, Hh, Hh, Hh, Hh, Hh, Gg, Gg, Gg, Gg, Gg, Gg, Gg, Gs, Gs, Dd, Gs^Fp, Dd, Dd, Dd, Gs^Fp, Kh, Kh, Dd, Dd, Dd, Rb, Dd^Ftd, Dd^Ftd, Ss, Ss, Dd^Ftd, Dd^Ftd, Dd^Ftd, Dd, Hhd, Hh, Aa^Fpa, Ms, Mm^Xm, Uh, Uu, Uu, Uu, Mm^Xm, Mm^Xm, Uh, Mm
Xu, Xu, Xu, Xu, Xu, Uu, Xu, Xu, Xu, Xu, Xu, Xu, Xu, Xu, Xu, Xu, Xu, Uh, Xu, Xu, Xu, Xu, Xu, Xu, Xu, Xu, Xu, Hh, Xu, Mm, Mm, Mm, Gs^Fp, Re, Re, Gs^Fp, Hh, Hh, Hh, Hh, Hh, Gg, Gg, Gg, Gg, Gg, Gg, Gg, Aa^Fpa, Gs^Fp, Gg^Efm, Gs^Fp, Gs^Fp, Gg, Gs^Fp, Gs^Fp, Gs^Fp, Kh, Gg, Gs, Gs, Gs, Gg, Rb, Dd^Ftd, Dd^Ftd, Dd^Ftd, Dd^Ftd, Dd^Ftd, Dd^Ftd, Dd, Hhd, Hh, Aa^Fpa, Ms, Mm^Xm, Mm^Xm, Uu, Mm^Xm, Mm^Xm, Uu, Uu, Mm^Xm, Mm
Xu, Xu, Xu, Xu, Xu, Uh, Uh, Xu, Xu, Xu, Xu, Xu, Xu, Xu, Xu, Xu, Xu, Qxu, Xu, Xu, Xu, Xu, Xu, Xu, Xu, Xu, Xu, Uu, Xu, Xu, Xu, Mm, Mm^Xm, Mm^Xm, Hh, Re, Re, Re, Re, Gg, Gg, Gg, Gg, Gg, Gg, Gg^Efm, Gg, Aa^Fpa, Aa^Fpa, Gs^Fp, Gs^Fp, Gs^Fp, Gg, Gg, Gg, Gg, Gs^Fp, Gg, Re, Gg, Re, Gg, Re, Rb, Rb, Dd^Ftd, Dd^Ftd, Dd^Ftd, Dd^Ftd, Dd^Ftd, Dd, Hhd, Hh, Hh, Ms, Mm^Xm, Mm^Xm, Mm^Xm, Uu, Uu, Mm^Xm, Mm^Xm, Mm^Xm, Mm
Xu, Xu, Xu, Xu, Xu, Xu, Xu, Uh, Uu, Xu, Uu, Xu, Xu, Xu, Xu, Xu, Xu, Qxu, Xu, Xu, Xu, Xu, Xu, Xu, Xu, Xu, Xu, Uh, Uh, Xu, Xu, Xu, Xu, Mm^Xm, Mm^Xm, Gg, Gg, Aa, Aa, Re, Re, Gg, Re, Re, Re, Re, Re, Gg, Hh, Gg, Gs^Fp, Gs^Fp, Re, Gg, Re, Re, Re, Re, Gs^Fp, Re, Gg, Re, Gs^Fp, Gs^Fp, Gg, Rb, Dd, Dd^Ftd, Dd, Dd, Hhd, Hhd, Hh, Hh, Ms, Ms, Mm^Xm, Mm^Xm, Uu, Mm^Xm, Mm^Xm, Mm, Mm^Xm, Mm
Xu, Xu, Xu, Xu, Xu, Xu, Xu, Xu, Uu, Xu, Xu, Uu, Uu, Uu, Uu, Xu, Qxu, Qxu, Xu, Xu, Xu, Xu, Xu, Xu, Xu, Xu, Uu, Uh, Xu, Uu, Uu, Xu, Uu, Xu, Uu, Mm^Xm, Mm, Aa, Aa, Aa^Fpa, Aa^Fpa, Re, Gg, Gg, Gg, Gg, Gg, Re, Re, Gg, Re, Re, Gg, Re, Gg, Gg, Gg, Gg, Gll^Fp, Gg, Gg, Gs^Fp, Gs^Fp, Gs^Fp, Gg, Rb, Rb, Dd, Hhd, Hhd, Gs^Fp, Hh, Gg, Hh, Ms, Ms, Ch, Mm^Xm, Uh, Mm^Xm, Mm, Mm^Xm, Mm^Xm, Ha
Xu, Xu, Xu, Xu, Xu, Xu, Uu, Uu, Xu, Xu, Xu, Xu, Xu, Qxu, Xu, Uu, Xu, Xu, Uu, Uu, Uu, Uu, Uu, Xu, Xu, Xu, Uu, Xu, Xu, Xu, Uu, Uu, Xu, Uu, Uu, Mm^Xm, Mm^Xm, Mm, Mm, Aa, Aa, Re, Re, Gg, Gg, Gg, Gg, Gg, Gg, Re, Gg, Gg, Gg, Gg, Gg, Gg, Gg, Gll^Fp, Gg, Gg, Gg, Gs^Fp, Gg^Efm, Gs^Fp, Gg, Hh, Hh, Rp, Rp, Hhd, Gs^Fp, Gg, Rp, Rp, Rp, Rp, Ms, Ch, Kh, Mm^Xm, Ms, Mm, Mm, Mm^Xm
Xu, Xu, Xu, Xu, Xu, Xu, Uu, Xu, Xu, Xu, Xu, Xu, Xu, Qxu, Xu, Xu, Ww^Efm, Ww^Efm, Ww^Efm, Uu, Uu, Uu, Xu, Xu, Xu, Uu, Xu, Xu, Xu, Xu, Xu, Xu, Xu, Xu, Mm, Mm^Xm, Mm, Mm, Aa, Gg, Gg, Gg, Re, Gg, Gg, Gg, Gg, Gg, Gg, Gg, Gg, Gg, Gg, Gg, Gg, Gg, Gg, Kh, Gg, Gg, Gg, Gg, Gs^Fp, Gs^Fp, Hh, Hh, Hh, Hh, Gg, Rp, Rp, Rp, Gs^Fp, Gs^Fp, Gg, Aa, Ch, Ch, Ch, Ch, Ch, Aa^Fpa, Ms, Mm
Xu, Xu, Xu, Xu, Xu, Xu, Uu, Xu, Xu, Xu, Uh, Uu, Uu, Uu, Ww^Efm, Ww^Efm, Ww^Efm, Ww^Efm, Ww^Efm, Ww^Efm, Uu, Uu, Xu, Xu, Uu, Uh, Xu, Xu, Xu, Xu, Xu, Xu, Mm, Mm, Mm^Xm, Mm^Xm, Ss, Gg, Gg, Gg, Gs^Fp, Gg, Gg, Re, Gg, Gg, Gg, Gg, Gg, Gg, Gg, Gg, Gg, Gs^Fp, Gg, Gg, Gg, Gg, Gg, Gg, Gg, Gg, Gg, Hh, Hh, Hh, Hh, Hh, Gg, Gg, Gg, Gs^Fp, Gs^Fp, Gg, Gg, Gg, Aa, Ms, Ch, Ms, Aa^Fpa, Aa^Fpa, Ha, Hh
Xu, Xu, Xu, Xu, Xu, Uu, Xu, Xu, Xu, Uu, Uu, Uu, Uu, Uu, Ww^Efm, Ww^Efm, Ww^Efm, Gg^Fet, Ww^Efm, Ww^Efm, Ww^Efm, Uu, Xu, Xu, Uh, Uu, Xu, Xu, Xu, Xu, Xu, Mm, Mm^Xm, Mm^Xm, Mm^Xm, Mm, Gg^Efm, Ss, Gs^Fp, Gs^Fp, Gg, Gs^Fp, Gg, Re, Gg, Gs^Fp, Gs^Fp, Gs^Fp, Gs^Fp, Gg, Gg, Gg, Gg, Gg, Gg, Gg, Gg, Gg, Gg, Gg, Gg, Gg, Gs^Fp, Hh, Hh, Hh, Hh, Hh, Gs^Fp, Gs^Fp, Gs^Fp, Gs^Fp, Gs^Fp, Gg, Gg, Gg, Gg, Gg, Gg, Aa^Fpa, Aa^Fpa, Ha, Ha, Gg
Xu, Xu, Xu, Xu, Xu, Uu, Xu, Xu, Xu, Uh, Uu, Uu, Ww^Efm, Ww^Efm, Ww^Efm, Ww^Efm, Ww^Efm, Uu^Bw|, Ww^Efm, Ww^Efm, Uu, Xu, Xu, Xu, Uu, Uu, Xu, Xu, Xu, Xu, Xu, Mm, Mm^Xm, Aa, Mm^Xm, Gg, Ss, Ss, Gs^Fp, Gg, Gg, Gg, Re, Re, Re, Gs^Fp, Hh, Gs^Fp, Hh, Gs^Fp, Mm, Hh, Aa, Gg, Gg, Gg, Gg, Gg, Gg, Gg, Gg, Gg, Gg, Gs^Fp, Hh, Hh, Gg, Gg, Gs^Fp, Gs^Fp, Gs^Fp, Gs^Fp, Gg, Gg, Gg, Gg, Gg, Gg, Gs^Fp, Aa^Fpa, Aa^Fpa, Aa^Fpa, Gg, Gg
Xu, Xu, Xu, Xu, Xu, Uu, Xu, Xu, Xu, Uu, Uu, Uu, Uh, Ww^Efm, Ww^Efm, Ww^Efm, Uu, Uu, Uu, Uu, Xu, Uu, Xu, Xu, Uu, Uu, Xu, Xu, Xu, Xu, Mm, Mm, Mm^Xm, Aa, Mm^Xm, Ss, Re, Gs^Fp, Re, Gg, Re, Re, Gg, Gg, Hh, Re, Gs^Fp, Gs^Fp, Hh, Gs^Fp, Gs^Fp, Hh, Aa, Gg, Gg, Gg, Gg, Gg, Gg, Gg, Gg, Gg, Gg, Gg, Gs^Fp, Gg, Gg, Gs^Fp, Gs^Fp, Gs^Fp, Gs^Fp, Gs^Fp, Gg, Gg, Gg, Gg, Gg, Gs^Fp, Gs^Fp, Gs^Fp, Gs^Fp, Aa^Fpa, Aa^Fpa, Gg
Xu, Xu, Xu, Xu, Xu, Uh, Xu, Xu, Xu, Uu, Uu, Uu, Uh, Uu, Uu, Uu, Uu, Uu, Uu, Xu, Xu, Uu, Uh, Uu, Xu, Xu, Xu, Xu, Xu, Xu, Mm, Mm^Xm, Gg, Aa, Mm^Xm, Mm, Gg, Re, Gg, Re, Gg, Gg, Gg, Hh, Hh, Re, Re, Ch, Ch, Ch, Hh, Hh, Gg, Gg, Gg, Gg, Gg, Gg, Gg, Gg, Gg, Gg, Gg, Gg, Gg, Gs^Fp, Gs^Fp, Gs^Fp, Gs^Fp, Gg, Gg, Gg, Gg, Gg, Gg, Gg, Gg, Gg, Gs^Fp, Gg, Gg, Gs^Fp, Gs^Fp, Gs^Fp
Xu, Xu, Xu, Xu, Uu, Uu, Xu, Xu, Xu, Xu, Uu, Uu, Xu, Uu, Xu, Uu, Xu, Xu, Xu, Xu, Xu, Xu, Uh, Xu, Xu, Xu, Xu, Xu, Xu, Xu, Mm, Mm^Xm, Gg, Gg, Aa, Mm^Xm, Mm, Aa, Gg, Gg, Gg, Gg, Gg, Gg, Aa, Aa, Gg, Ch, 6 Kh, Ch, Hh, Hh, Hh, Gg, Gg, Gg, Gg, Gg, Gg, Gg, Gg, Gg, Gg, Gg, Gg, Gg, Gs^Fp, Gs^Fp, Gg, Ds, Ds, Ds, Gg, Gg, Gg, Gg, Gg, Gg, Gs^Fp, Gg, Ds, Gg, Gs^Fp, Gs^Fp
Xu, Xu, Xu, Xu, Uu, Xu, Uu, Xu, Uu, Uu, Xu, Xu, Xu, Xu, Xu, Xu, Xu, Xu, Xu, Xu, Xu, Uu, Xu, Xu, Xu, Xu, Xu, Xu, Xu, Xu, Mm, Mm^Xm, Mm^Xm, Gg, Aa, Mm^Xm, Mm^Xm, Mm, Gg, Gg, Gg, Hh, Gg, Hh, Hh, Aa, Ch, Ch, Ch, Hh, Mm, Mm, Hh, Gs^Fp, Gs^Fp, Gs^Fp, Gg, Gg, Gg, Gg, Gg, Gg, Gg, Gg, Gg, Ds, Ds, Ds, Ds, Ds, Ds, Ds, Gg, Gg, Gg, Gg, Gg, Gg, Gg, Ds, Ds, Ds, Ds, Gs^Fp
Xu, Xu, Xu, Xu, Xu, Uu, Uu, Uu, Uu, Xu, Uu, Xu, Xu, Xu, Xu, Xu, Uu, Xu, Uh, Uu, Uu, Uu, Uu, Xu, Xu, Xu, Xu, Xu, Xu, Xu, Xu, Mm, Mm, Mm^Xm, Mm^Xm, Gs^Fp, Mm^Xm, Aa^Fpa, Gg, Gg, Gg, Gg, Gg, Mm, Mm, Hh, Hh, Ha, Ha, Mm, Hh, Hh, Gs^Fp, Gs^Fp, Gs^Fp, Gs^Fp, Gs^Fp, Gg, Gg, Gg, Gg, Gg, Gg, Ds, Ds, Ww, Wo, Ww, Ds, Ds, Ds, Ds, Gg, Gg, Gg, Gg, Gg, Gg, Ds, Ds, Ww, Ww, Ds, Gs^Fp
Xu, Xu, Uu, Xu, Xu, Xu, Xu, Xu, Xu, Uu, Uu, Uu, Uu, Qxu, Qxu, Uu, Uu, Uh, Xu, Xu, Xu, Xu, Xu, Uu, Uh, Xu, Uh, Uu, Uu, Xu, Xu, Xu, Ha, Mm, Mm^Xm, Aa, Mm^Xm, Mm, Gg, Gs^Fp, Gs^Fp, Gg, Gg, Mm, Hh, Hh, Hh, Ha, Hh, Hh, Gg, Gs^Fp, Gg, Gg, Gs^Fp, Gg, Gs^Fp, Gs^Fp, Gg, Gg, Gg, Gg, Gg, Ds^Bw\, Ww^Bw\, Wo, Wo, Wo, Ww^Bw\, Ds, Ds, Ds, Gg, Gg, Ds, Ds, Gg, Gg, Ds, Ds, Wo, Ww, Ds, Gs^Fp
Xu, Uu, Uu, Uu, Uu, Xu, Xu, Xu, Xu, Xu, Xu, Xu, Xu, Xu, Xu, Xu, Uu, Xu, Xu, Xu, Xu, Xu, Xu, Uu, Uu, Ww, Uu, Uu, Xu, Xu, Xu, Xu, Mm, Mm^Xm, Aa, Gg, Mm^Xm, Gg, Gs^Fp, Gs^Fp, Gs^Fp, Gg, Gg, Hh, Gs^Fp, Hh, Gg, Ha, Aa, Gg, Gs^Fp, Gs^Fp, Gs^Fp, Gs^Fp, Gs^Fp, Gs^Fp, Gs^Fp, Gg, Gg, Gg, Gg, Gg, Gs^Fp, Ds, Ds, Ww^Bw\, Ww^Bw/, Ww^Bw/, Wo, Ds^Bw\, Ds^Bw/, 4 Ds^Bw/, Gg, 5 Ds, Ds, Ds, Ds, Ds, Ds, Ww, Wo, Ww, Ds, Ds
Xu, Uu, Gg^Fet, Gg^Fet, Gg^Fet, Uu, Uu, Xu, Uh, Xu, Xu, Xu, Xu, Xu, Uu, Uu, Xu, Xu, Xu, Xu, Xu, Xu, Xu, Xu, Uu, Uu, Gg^Fet, Uu, Uu, Xu, Xu, Xu, Mm, Mm^Xm, Mm^Xm, Gg, Mm^Xm, Mm, Gg, Gs^Fp, Gg, Gg, Gg, Gg, Gg, Gg, Gg, Aa, Aa, Gg, Gs^Fp, Gg, Gg, Gg, Gs^Fp, Gg, Gs^Fp, Gs^Fp, Gg, Gg, Gg, Gs^Fp, Gs^Fp, Ds, Ds, Wo, Wo, Wo, Wo, Ds, Ds, 2 Ds, 1 Ds, 3 Ds, Ds, Ds, Ww, Wo, Wo, Wo, Wo, Ww, Ds, Ds
Xu, Uu, Uu, Gg^Fet, Uu, Uu, Xu, Uu, Xu, Uh, Uh, Uu, Uu, Uu, Xu, Uu, Xu, Xu, Xu, Xu, Xu, Xu, Xu, Xu, Xu, Uu, Uu, Uu, Uu, Uu, Xu, Xu, Ha, Mm, Mm, Mm^Xm, Mm^Xm, Mm, Mm, Gg, Gg, Gg, Gg, Gg, Gg, Gg, Gg, Aa, Aa, Gg, Gs^Fp, Gs^Fp, Gg, Ss, Ss, Ss, Gs^Fp, Gs^Fp, Gg, Gg, Gs^Fp, Gs^Fp, Ds, Ds, Ds, Wo, Wo, Wo, Wo, Wo, Wo, Ds, Wo, Ds, Wo, Wo, Ww, Wo, Wo, Wo, Wo, Ds, Ds, Gs^Fp
Xu, Xu, Xu, Uu, Xu, Xu, Xu, Xu, Xu, Xu, Xu, Xu, Xu, Xu, Xu, Xu, Xu, Xu, Xu, Xu, Xu, Xu, Xu, Xu, Xu, Xu, Xu, Xu, Xu, Xu, Xu, Xu, Aa, Ha, Aa, Mm, Mm^Xm, Mm^Xm, Mm, Gg, Gg, Gg, Gg, Gg, Gg, Gg, Gg, Aa, Aa, Gg, Gg, Gg, Gs^Fp, Ss, Ss, Ss, Gs^Fp, Gs^Fp, Gg, Gg, Gg, Gs^Fp, Gs^Fp, Wo, Wo, Wo, Wo, Wo, Wo, Wo, Wo, Wo, Wo, Wo, Wo, Wo, Wo, Ww, Ww, Wo, Ww, Ds, Ss, Gs^Fp
