border_size=1
usage=map

Xu          , Xu          , Xu          , Xu          , Xu          , Xu          , Xu          , Xu          , Xu          , Xu          , Xos         , Xos         , Xos         , Xos         , Xos         , Xos         , Xos         , Xu          , Xu          , Xu          , Xu          , Xu          , Xu          , Xu          , Xu          , Xos         , Ql          , Qxu         , Qxu         , Qxu         , Qxu         , Ql          , Ql          , Ql          , Ql          , Ql          , Ql          , Ql          , Qxu         , Qxu         , Qxu         , Qxu         
Qxu         , Xu          , Xu          , Xu          , Xu          , Xos         , Xu          , Xos         , Xos         , Xos         , Cud         , Cud         , Cud         , Cud         , Cud         , Cud         , Cud         , Xos         , Xos         , Xos         , Xu          , Xu          , Xu          , Xu          , Xu          , Xos         , Uh^Ii       , Qxu         , Qxu         , Qxu         , Ql          , Ql          , Cud         , Cud         , 9 Kud       , Cud         , Cud         , Ql          , Ql          , Qxu         , Qxu         , Qxu         
Qxu         , Xu          , Xu          , Xu          , Xu          , Rr          , Ur          , Rr          , Rr          , Cud         , Cud         , Cud         , Cud         , 8 Kud       , Cud         , Cud         , Cud         , Cud         , Rr          , Rr          , Rr          , Xu          , Xos         , Xu          , Xu          , Xos         , Ql          , Qxu^Bs\     , Cud         , Ql          , Ql          , Cud         , Ql          , Cud         , Cud         , Cud         , Ql          , Cud         , Ql          , Qxu         , Qxu         , Qxu         
Xu          , Qxu         , Qxu         , Xu          , Rr          , Ur          , Ur          , Ur          , Ur          , Rr          , Ur          , Cud         , Rr          , Cud         , Ur          , Cud         , Rr          , Ur          , Ur          , Ur          , Ur          , Ur          , Rr          , Xu          , Xu          , Xos         , Ql          , Qxu         , Ql          , Ql^Bs\      , Cud         , Cud         , Ql          , Cud         , Cud         , Cud         , Ql          , Cud         , Cud         , Ql          , Qxu         , Qxu         
Xu          , Qxu         , Qxu         , Xu          , Qxu         , Ur          , Qxu         , Qxu         , Qxu^Bs|     , Ur          , Ur          , Rr          , Ur          , Rr          , Ur          , Rr          , Ur          , Ur          , Ur          , Rr          , Rr          , Rr          , Ur          , Xu          , Xu          , Xos         , Ql          , Ql          , Ql          , Ql          , Ql          , Ql          , Ql          , Cud         , Cud         , Cud         , Ql          , Ql          , Ql          , Ql          , Qxu         , Qxu         
Xu          , Xu          , Uu          , Qxu         , Uu          , Qxu^Bs|     , Rr          , Uu^Uf       , Uu          , Qxu         , Qxu         , Ur          , Rr          , Ur          , Rr          , Rr          , Ur          , Ur          , Ur          , Ur          , Xu          , Ur          , Ur          , Rr          , Xu          , Xos         , Xos         , Ql          , Ql          , Ql          , Ql          , Ql          , Cud         , Cud         , Cud         , Cud         , Cud         , Ql          , Ql          , Ql          , Ql          , Qxu         
Xu          , Xu          , Uu          , Xu          , Uu          , Uu          , Rr          , Ur          , Xu          , Uu^Uf       , Qxu         , Xu          , Xu          , Xu          , Xu          , Xu          , Xu          , Rr          , Ur          , Rr          , Xu          , Xu          , Xu          , Ur          , Ur          , Xu          , Xos         , Xos         , Ql          , Ql          , Ql          , Ql          , Ql          , Cud         , Cud         , Cud         , Ql          , Ql          , Ql          , Ql          , Ql          , Ql          
Xu          , Uu          , Xu          , Xu          , Xu          , Uu          , Ur          , Ur          , Xu          , Xu          , Xu          , Qxu         , Qxu         , Xu          , Xu          , Xu          , Xu          , Rr          , Ur          , Rr          , Xu          , Xu          , Xos         , Ur          , Rr          , Xu          , Xu          , Xos         , Xos         , Xos         , Xos         , Ql          , Cud         , Cud         , Cud         , Cud         , Cud         , Qlf         , Qlf         , Ql          , Ql          , Ql          
Xu          , Uu          , Xu          , Xu          , Xu          , Xu          , Ur          , Ur          , Xu          , Uu^Uf       , Ur          , Ur          , Qxu         , Rr          , Ur          , Xu          , Xu          , Rr          , Ur          , Ur          , Xu          , Xu          , Xu          , Ur          , Rr          , Xu          , Xu          , Xu          , Rr          , Xos         , Xos         , Rr          , Rr          , Rr          , Cud         , Rr          , Rr          , Rr          , Qlf         , Qlf         , Ql          , Ql          
Xu          , Ur          , Xu          , Xu          , Xu          , Rr          , Rr          , Ur          , Xu          , Xu          , Xu          , Ur          , Rp          , Qxu^Bs/     , Ur          , Rr          , Xu          , Ur          , Ur          , Ur          , Xu          , Xu          , Xu          , Xu          , Xu          , Rr          , Xu          , Xu          , Ur          , Xu          , Xos         , Rr          , Rr          , Rr          , Rr          , Rr          , Rr          , Rr          , Rr          , Qlf         , Qlf         , Qlf         
Xu          , Ur          , Uu^Uf       , Xu          , Xu          , Rr          , Rr          , Rr          , Ur          , Xu          , Uu^Uf       , Xu          , Ur          , Qxu         , Qxu         , Ur          , Rr          , Rr          , Ur          , Rr          , Cud         , Xu          , Xu          , Xu          , Xu          , Rr          , Xu          , Xu          , Ur          , Xu          , Xu          , Xos         , Rr          , Rr          , Rr          , Rr          , Rr          , Rr          , Rr          , Rr          , Qlf         , Qlf         
Xu          , Ur          , Uu^Uf       , Xu          , Xu          , Rr          , Rr          , Rr          , Rr          , Rr          , Xu          , Xu          , Xu          , Ur          , Qxu         , Ur          , Ur          , Ur          , Rr          , Rr          , Xu          , Xu          , Xu          , Xu          , Xu          , Rr          , Ur          , Xu          , Xu          , Ur          , Xu          , Xos         , Xos         , Rr          , Xos         , Rr          , Rr          , Rr          , Rr          , Rr          , Qlf         , Qlf         
Xu          , Xu          , Xos         , Xu          , Xu          , Ur          , Rr          , Ur          , Rr          , Ur          , Xu          , Xu          , Ur          , Ur          , Qxu         , Rr          , Rr          , Uu^Uf       , Xu          , Xu          , Xu          , Xu          , Xu          , Xu          , Xu          , Xu          , Ur          , Xu          , Xu          , Ur          , Xu          , Xu          , Xu          , Xos         , Xu          , Xos         , Rr          , Rr          , Rr          , Rr          , Qlf         , Qlf         
Xu          , Xu          , Uu^Uf       , Xu          , Ur          , Ur          , Ur          , Rr          , Xu          , Ur          , Xos         , Xu          , Rp          , Qxu         , Xu          , Xu          , Ur          , Rr          , Xu          , Xu          , Xu          , Xu          , Uu          , Xu          , Xos         , Xu          , Ur          , Xu          , Ur          , Ur          , Uh          , Xu          , Xu          , Xu          , Rr          , Xos         , Xos         , Rr          , Rr          , Rr          , Qlf         , Qlf         
Xu          , Xu          , Rr          , Cud         , Xu          , Ur          , Xu          , Xu          , Uu^Uf       , Xu          , Xu          , Xu          , Ur          , Qxu         , Xu          , Ur          , Rr          , Xu          , Xu          , Xu          , Xu          , Uu          , Xu          , Uu          , Xu          , Xu          , Xu          , Ur          , Xu          , Ur          , Ur          , Uh          , Ur          , Cud         , Xu          , Xu          , Xos         , Rr          , Rr          , Rr          , Rr          , Xos         
Xu          , Xu          , Ur          , Xu          , Xu          , Xu          , Xu          , Xu          , Ur          , Ur          , Rp          , Ur          , Qxu         , Qxu         , Ur          , Ur          , Rr          , Xu          , Xu          , Xu          , Xu          , Uu^Ufi      , Xu          , Uu          , Xu          , Xu          , Xu          , Xu          , Uh          , Uh          , Ur          , Uu^Ufi      , Ur          , Uh          , Xu          , Xu          , Xu          , Xos         , Cud         , Rr          , Cud         , Xos         
Xu          , Xu          , Re          , Xu          , Xu          , Xu          , Ur          , Ur          , Xu          , Xu          , Xu          , Xu          , Qxu         , Xu          , Qxu^Bs|     , Qxu^Bs|     , Qxu^Bs|     , Ur          , Xu          , Xu          , Xu          , Xu          , Ur          , Uu          , Xu          , Xu          , Xu          , Uh          , Ur          , Ur          , Ur          , Ur          , Ur          , Uh          , Xu          , Xu          , Xu          , Xu          , Uu          , Uu          , Uu          , Xu          
Xu          , Xu          , Xu          , Xu          , Xu          , Xu          , Rp          , Xu          , Xu          , Xu          , Qxu         , Qxu         , Qxu         , Qxu         , Ur          , Rr          , Ur          , Qxu         , Xu          , Xu          , Uh          , Xu          , Ur          , Xu          , Xu          , Xu          , Uh          , Uh          , Ur          , Ur          , Ur          , Ur          , Uh          , Uh          , Xu          , Xu          , Xu          , Xos         , Uu          , Uh          , Uh          , Xu          
Xu          , Xu          , Xu          , Xu          , Ur          , Ur          , Xu          , Xu          , Xu          , Qxu         , Qxu         , Qxu         , Cud         , Qxu         , Qxu^Bs|     , Qxu         , Ur          , Qxu         , Qxu         , Uh          , Xu          , Uh          , Xu          , Xu          , Xu          , Xu          , Uh          , Uh          , Uu^Ufi      , Ur          , Ur          , Uh          , Xu          , Xu          , Xu          , Xu          , Xu          , Xu          , Uu          , Uh          , Uh          , Xu          
Xu          , Xu          , Xu          , Xu          , Ur          , Xu          , Xu          , Xu          , Qxu         , Qxu         , Cud         , Qxu         , Cud         , Qxu         , Cud         , Qxu^Bs/     , Qxu         , Ur          , Qxu^Bs\     , Xu          , Uu^Uf       , Xu          , Xu          , Xu          , Xu          , Uh          , Ur          , Ur          , Ur          , Ur          , Ur          , Uu^Ufi      , Uh          , Xu          , Xu          , Xu          , Xu          , Xos         , Uu          , Uu          , Uh          , Xu          
Xu          , Xu          , Xu          , Ur          , Xu          , Xu          , Xu          , Xu          , Qxu         , Qxu         , Qxu         , Cud         , 6 Kud       , Cud         , Qxu         , Qxu^Bs\     , Ur          , Qxu         , Rr          , Rr          , Rr          , Xu          , Xu          , Xu          , Uh          , Uh          , Ur          , Ur          , Ur          , Ur          , Ur          , Ur          , Uh          , Xu          , Xu          , Xu          , Xu          , Xu          , Uh          , Uh          , Uu          , Xu          
Xu          , Xu          , Xu          , Ur          , Xu          , Xu          , Xu          , Xu          , Qxu         , Qxu         , Cud         , Cud         , Cud         , Cud         , Cud         , Qxu^Bs/     , Qxu         , Ur          , Rr          , Uu          , Rr          , Xu          , Xos         , Xu          , Xu          , Uh          , Ur          , Ur          , Uh          , Ur          , Uh          , Ur          , Uh          , Xu          , Xu          , Xu          , Xu          , Xu          , Uu          , Uu          , Uu          , Xu          
Xu          , Xu          , Rp          , Rp          , Xu          , Xu          , Xu          , Xu          , Rr          , Qxu^Bs/     , Qxu         , Qxu         , Cud         , Qxu         , Qxu^Bs|     , Qxu^Bs\     , Uu          , Qxu         , Uu          , Uu          , Rr          , Rr          , Xu          , Xu          , Xu          , Uh          , Cud         , Xu          , Xu          , Uh          , Uh          , Uh          , Xu          , Xu          , Uu          , Uu          , Uu          , Uu          , Uu          , Uu          , Uu          , Xu          
Xu          , Xu          , Rp          , Xu          , Xu          , Xu          , Ur          , Ur          , Rr          , Qxu         , Rr          , Qxu^Bs/     , Qxu^Bs|     , Qxu^Bs\     , Ur          , Qxu         , Uu          , Uu          , Uu          , Rr          , Rr          , Rr          , Rr          , Xu          , Xu          , Xu          , Ur          , Ur          , Xu          , Xu          , Xu          , Xu          , Xu          , Uu          , Uu          , Uu          , Uu          , Uh          , Uh          , Uu          , Uu^Ufi      , Xu          
Xu          , Xu          , Xu          , Ur          , Xu          , Xu          , Ur          , Rr          , Qxu         , Qxu         , Rr          , Qxu         , Ur          , Qxu         , Ur          , Ur          , Xu          , Xu          , Xos         , Xu          , Rr          , Rr          , Uu          , Xu          , Xos         , Xu          , Xu          , Ur          , Ur          , Xos         , Xu          , Xu          , Cud         , Uu          , Uu          , Uu          , Uu          , Uu          , Uh          , Uh          , Uu          , Xu          
Xu          , Xu          , Xu          , Ur          , Ur          , Xu          , Xu          , Ur          , Qxu         , Qxu         , Qxu         , Ur          , Xu          , Ur          , Rr          , Rr          , Xu          , Xu          , Xu          , Xu          , Xu          , Uu          , Uu          , Rr          , Xu          , Xu          , Xu          , Ur          , Ur          , Ur          , Ur          , Ur          , Xu          , Xu          , Xu          , Xu          , Xos         , Xu          , Uh          , Uh          , Xu          , Xu          
Xu          , Xu          , Xu          , Rp          , Ur          , Xu          , Xu          , Rr          , Rr          , Qxu         , Qxu         , Qxu^Bs|     , Qxu         , Xu          , Xos         , Xu          , Xu          , Xu          , Xu          , Xos         , Xu          , Rr          , Uu          , Uu          , Rr          , Xu          , Xu          , Xu          , Ur          , Ur          , Re          , Ur          , Xu          , Xu          , Rr          , Xu          , Rr          , Xu          , Xu          , Xu          , Xu          , Xu          
Xu          , Xu          , Xu          , Ur          , Cud         , Xu          , Xu          , Ur          , Rr          , Ur          , Ur          , Uu^Uf       , Qxu         , Xu          , Xu          , Xu          , Xos         , Xu          , Rr          , Rr          , Rr          , Rr          , Uu          , Uu          , Rr          , Rr          , Xu          , Xu          , Xu          , Ur          , Xu          , Xu          , Uu^Uf       , Cud         , Xu          , Rr          , Rr          , Xu          , Xu          , Xu          , Mm^Xm       , Mm^Xm       
Xu          , Xu          , Xu          , Xu          , Ur          , Xu          , Xu          , Xu          , Ur          , Ur          , Qxu         , Qxu         , Ur          , Xu          , Xu          , Xu          , Xu          , Rr          , Rr          , Rr          , Xu          , Rr          , Rr          , Rr          , Rr          , Xu          , Xu          , Xu          , Xos         , Xu          , Xos         , Xu          , Xu          , Xu          , Xu          , Cud         , Cud         , Xu          , Xos         , Xu          , Mm^Xm       , Mm^Xm       
Xu          , Xu          , Re          , Ur          , Ur          , Xu          , Xu          , Xu          , Xu          , Rr          , Rr          , Qxu         , Ur          , Xu          , Xu          , Xu          , Xu          , Rr          , Rr          , Xu          , Rr          , Xu          , Xu          , Rr          , Rr          , Rr          , Rr          , Xu          , Rr          , Xu          , Cud         , Xu          , Rr          , Aa          , Uh          , Aa          , Ur          , Xu          , Aa^Ii       , Mm^Xm       , Mm^Xm       , Mm^Xm       
Xu          , Xu          , Xu          , Xu          , Xu          , Cud         , Rr          , Xu          , Xu          , Xu          , Rr          , Qxu         , Qxu         , Ur          , Xu          , Xu          , Xos         , Rr          , Rr          , Rr          , Xu          , Uu^Uf       , Xu          , Rr          , Rr          , Rr          , Aa          , Rr          , Rr          , Rr          , Cud         , Rr          , Rr          , Aa          , Ur          , Ur          , 1 Chr       , 3 Chr       , 5 Chr       , Ms          , Ms          , Ms          
Xu          , Xu          , Xu          , Xu          , Xu          , Ur          , Rr          , Cud         , Cud         , Xu          , Rr          , Rr          , Qxu         , Xu          , Xu          , Xu          , Xu          , Xu          , Xos         , Xu          , Xu          , Xu          , Rr          , Rr          , Rr          , Aa          , Xu          , Rr          , Rr          , Aa          , Cud         , Rr          , Uu^Uf       , Aa          , Ur          , Ur          , Ur          , Re          , 4 Chr       , Ms          , Ms          , Ms          
Xu          , Xu          , Xu          , Xu          , Ur          , Ur          , Rr          , Rr          , Rr          , Rr          , Rr          , Cud         , Ur          , Qxu         , Qxu         , Xu          , Xu          , Xu          , Xu          , Xu          , Xu          , Xu          , Xu          , Rr          , Rr          , Xu          , Ur          , Xu          , Xu          , Cud         , Ur          , Rr          , Rr          , Ur          , Aa          , Ur          , Ur          , 2 Chr       , Aa          , Aa          , Ms          , Ms          
Xu          , Xu          , Xu          , Xu          , Cud         , Rr          , Rr          , Rr          , Cud         , Rr          , Rr          , Cud         , Ur          , Ur          , Cud         , Qxu         , Xu          , Xu          , Xos         , Xu          , Xu          , Xu          , Xu          , Xu          , Xu          , Xu          , Ur          , Xu          , Xu          , Xu          , Xos         , Xu          , Xu          , Uh          , Xu          , Ur          , Xu          , Aa^Ii       , Ha          , Ha          , Ha          , Ms          
Xu          , Xu          , Xu          , Xu          , Cud         , Rr          , Rr          , Ur          , Ur          , Cud         , Cud         , Cud         , Cud         , Cud         , Qxu         , Qxu         , Xu          , Xu          , Rr          , Xu          , Xu          , Xu          , Xos         , Xu          , Xu          , Xu          , Cud         , Xu          , Xu          , Xu          , Xu          , Xos         , Xu          , Xos         , Xu          , Xos         , Xu          , Aa^Ii       , Ms          , Ha          , Ha          , Ha          
Xu          , Xu          , Xu          , Xu          , Xu          , Cud         , Rr          , Ur          , Ur          , Ur          , Cud         , 7 Kud       , Cud         , Ur          , Qxu         , Xu          , Xu          , Xu          , Xu          , Rr          , Xu          , Xu          , Rr          , Xu          , Xu          , Xu          , Uu^Ufi      , Xu          , Cud         , Ur          , Rr          , Xu          , Xu          , Xu          , Xu          , Xu          , Xu          , Xu          , Mm^Xm       , Ms          , Ms          , Ha          
Xu          , Xu          , Xu          , Xu          , Xu          , Xu          , Ur          , Rr          , Cud         , Cud         , Ur          , Cud         , Ur          , Cud         , Cud         , Qxu         , Xu          , Xu          , Xu          , Rr          , Ur          , Rr          , Xos         , Ur          , Ur          , Rr          , Rr          , Rr          , Xu          , Ur          , Ur          , Xu          , Xu          , Xu          , Xu          , Xu          , Xu          , Xu          , Mm^Xm       , Mm^Xm       , Ms          , Ha          
Xu          , Xu          , Xu          , Xu          , Xu          , Xu          , Xu          , Ur          , Rr          , Ur          , Ur          , Cud         , Rr          , Rr          , Ur          , Qxu         , Qxu^Bs/     , Xu          , Rr          , Ur          , Ur          , Ur          , Ur          , Rr          , Rr          , Rr          , Rr          , Xu          , Xu          , Ur          , Ur          , Uu^Uf       , Xu          , Xu          , Xu          , Xu          , Xu          , Xu          , Mm^Xm       , Ms          , Ha          , Ha          
Xu          , Xu          , Xu          , Xu          , Xu          , Xu          , Xu          , Xu          , Xu          , Xu          , Rr          , Cud         , Rr          , Rr          , Rr          , Rr          , Cud         , Qxu         , Ur          , Ur          , Xu          , Ur          , Xu          , Rr          , Xu          , Ur          , Xu          , Xu          , Xu          , Xu          , Xu          , Rr          , Xu          , Xu          , Xu          , Xu          , Xu          , Xu          , Mm^Xm       , Ms          , Ms          , Ha          
Xu          , Xu          , Xu          , Xu          , Xu          , Xu          , Xu          , Xu          , Xu          , Xu          , Xu          , Xu          , Xu          , Xu          , Xu          , Rr          , Rr          , Qxu         , Qxu^Bs|     , Xu          , Xu          , Xu          , Xu          , Xu          , Xu          , Cud         , Xu          , Xu          , Xu          , Xu          , Xu          , Xos         , Xu          , Xu          , Xu          , Xu          , Xu          , Mm^Xm       , Mm^Xm       , Ms          , Ms          , Ha          
Xu          , Xu          , Xu          , Xu          , Xu          , Xu          , Xu          , Xu          , Xu          , Xu          , Xu          , Xu          , Xu          , Xu          , Xu          , Xu          , Uu^Uf       , Cud         , Cud         , Qxu         , Xu          , Xu          , Xos         , Xu          , Xos         , Rr          , Xu          , Xu          , Xu          , Xu          , Xu          , Xu          , Xu          , Xu          , Xu          , Xu          , Mm^Xm       , Mm^Xm       , Mm^Xm       , Mm^Xm       , Ms          , Ms          
Xu          , Xu          , Xu          , Xu          , Xu          , Xu          , Xu          , Xu          , Xu          , Xu          , Xu          , Xu          , Xu          , Xu          , Xu          , Xu          , Xu          , Xu          , Xu          , Qxu         , Qxu         , Xu          , Xu          , Xu          , Xu          , Xu          , Xu          , Xu          , Xu          , Xu          , Xu          , Xu          , Xu          , Xu          , Xu          , Xu          , Mm^Xm       , Mm^Xm       , Mm^Xm       , Mm^Xm       , Mm^Xm       , Ms          
