Xu, Xu, Xu, Xu, Xu, Xu, Xu, Xu, Xu, Xu, Xu, Xu, Xos, Xu, Xos, Xu, Xos, Xu, Xu, Xu, Xu, Xu, Xu, Xu, Xu, Xu, Xos, Qxu, Xos, Xu, Xu, Xu, Wog, Wog, Xu, Xu, Xu, Urb, Xu, Xu, Xu, Xu
Xu, Xu, Xu, Xu, Xu, Xu, Xu, Xu, Xu, Xu, Xu, Xu, Re, Xu, Rd, Xu, Re, Xu, Xu, Xu, Uh^Uf, Xuc, Xuc, Xu, Xu, Xu, Xos, Qxu, Xos, Xu, Xu, Xu, Wog, Wog, Wog, Xu, Xos, Xu, Xu, Xu, Xu, Xu
Xu, Xu, Xu, Xu, Uu, Kh, Cud, Xu, Xu, Xu, Re^Edb, Rd^Edb, Re^Edb, Rd^Edb, Re, Re^Es, Re^Edb, Rd^Edb, Re^Edb, Xuc, Uu^Es, Ss, Ss, Xuc, Xos, Xos, Urb, Urb, Cud, Xos, Xos, Xu, Xuc, Wog, Wog, Wog, Wog, Xos, Xos, Xu, Xu, Xu
Xu, Xu, Xu, Xu, Xu, Cud, Uu, Xu, Xu, Xu, Re, Chr^Eb, Re^Edb, Re, Ch, Re^Edb, Rd, Chr^Eb, Re, Uu, Wwrg, Wog, Wwrg, Xuc, Chw, Chw, Urb, Urb, Urb, Cud, Xuc, Xuc, Wwg, Wwg, Wwg, Wog, Wog, Wog, Wog, Xos, Xu, Xu
Xu, Xu, Xu, Xu, Xu, Xu, Xu, Uu, Xu, Xu, Rd, Re^Es, Re^Es, Chr^Edb, Kh, Chr, Re, Rd^Edb, Re, Xuc, Xu, Xu, Xuc, Wwrg, Wwg, Urb, Urb, Urb, Urb, Urb, Wwg, Wwg, Cme, Wwg, Wwg, Wwg, Wwg, Wwg, Wwg, Xos, Xos, Xu
Xu, Xu, Xu, Uh, Xu, Xu, Xu, Xu, Xu, Xu, Re, Rd^Edb, Re^Edb, Chr, Ch, Chr, Re^Edb, Re, Rd, Xu, Xu, Xu, Xuc, Chw, Urb, Wwg, Wwg, Urb, Wwg, Wwg, Cme, Cme, Cme, 10 Kme, Cme, Wwg, Wwg, Xuc, Wwg, Xos, Xos, Xu
Xu, Uh, Uh, Rd, Uu, Xu, Xu, Xu, Xu, Xu, Re, Chr^Eb, Re, Re, Re, Rd^Edb, Re, Chr^Eb, Re, Xu, Xu, Xu, Xuc, Chw, Urb, Urb, Wwg, Wwg, Urb, Urb, Rr, Rr, Urb, Cme, Urb, Wwg, Xuc, Xuc, Wwg, Wog, Xos, Xu
Xu, Uu, Uh, Re, Qxu, Xu, Xu, Cud, Rd, Rd, Ds, Re^Edb, Xu, Rd, Re^Es, Re^Es, Xu, Re, Xu, Xu, Xu, Xu, Xu, Xu, Urb, Urb, Wwg, Wwg, Rr, Rr, Urb, Urb, Urb, Urb, Urb, Urb, Xu, Xu, Wwg, Wog, Xos, Xos
Xu, Uh, Uu, Re, Re, Re, Re, Rd, Uu, Cud, Cud, Xu, Xu, Xu, Xu, Xu, Xu, Ur^Br|, Xu, Xu, Xu, Xu, Xos, Xos, Chw, Wwg, Wwrg, Rr, Urb, Urb, Urb, Urb, Urb, Urb, Xu, Cud, Xu, Xu, Wwg, Wwg, Xos, Xos
Xu, Xu, Re, Qxu, Cud, Cud, Ds, Ds, Rd, Uh^Uf, Xu, Xu, Xu, Xu, Xu, Xos, Xu, Ur^Br|, Xu, Xu, Xol, Xol, Wwg, Wog, Wwrg, Wwrg, Chw, Urb, Urb, Urb, Cud, Urb, Urb, Xu, Re^Ii, Xu, Xu, Xu, Wwg, Xos, Xos, Xos
Xu, Xu, Uh^Uf, Rd, 11 Kud, Cud, Ds, Ds, Uu, Uh, Xu, Xu, Xos, Xu, Xu, Xu, Ur^Br/, Ur^Br|, Xu, Xos, Cud, Rr, Rr, Wwrg, Wwg, Wog, Xos, Xos, Xos, Xu, Xu, Xu, Xu, Xu, Re^Ii, Urb^Ii, Uu, Wwf, Chw, Xos, Xos, Xos
Xu, Xu, Uh^Uf, Cud, Cud, Cud, Ds, Ds, Re, Urb, Urb, Xol, Xol, Xos, Xos, Xu^_s, Xu, Xu, Xu, Xos, Urb, Rr, Urb, Wwg, Xol, Xos, Xos, Xos, Xu, Xu, Xu, Xu, Ss, Ss, Uu, Re^Es, Wwf, Chw, Kh, Wog, Wog, Xos
Xu, Xu, Uu^Uf, Cud, Ds, Ds, Ds, Ds, Uue, Xu, Xos, Cud, Rr, Urb, Urb, Xos, Xos, Xos, Xos, Xos, Urb, Rr, Wwrg, Wwg, Chw, Xol, Xu, Xu, Xu, Xu, Xu, Xu, Ss, Ss, Ss, Xu, Re^Es, Chw, Wwf, Wog, Wog, Wog
Xu, Xu, Xu, Dd, Ds, Ds, Uh, Uue, Xu, Xos, Xos, Xos, Urb, Rr, Rr, Urb, Urb, Xos, Xos, Xos, Xos, Chw, Wog, Wwrg, Rr, Urb, Urb, Xu, Xu, Xu, Xu, Ss, Ss, Ss, Xu, Xu, Wwf, Wwf^Em, Ss, Xu, Ss, Wog
Xu, Xu, Xu, Ds, Cud, Uu, Xu, Xu, Xu, Xu, Xu, Xos, Xos, Urb, Urb, Rr, Cud, Cud, Xu, Xu, Xu, Xu, Uh, Urb, Urb, Rr, Cud, Cud, Urb, Xu, Xu, Xu, Ss, Ss, Xu, Re, Re, Xu, Ss, Ss, Xu, Xu
Xu, Xu, Xu, Xu, Ds, Ds, Xu, Xu, Xu, Xu, Xu, Xu^_s, Xu^_s, Xos, Xos, Cud, Rr, Urb, Xu, Qxu, Uh, Uh^Emf, Uh, Uh, Xos, Cud, Urb, Rr, Rr, Xuc, Xu, Xu, Xu, Ss, Wwg, Wwg, Ss, Ss, Xu, Xu, Xu, Xu
Xu, Xu, Uh, Ds, Re, Xu, Xu, Xu, Rr, Cud, Ur^Br/, Ur^Br/, Xu, Xu, Xos, Urb, Rr, Urb, Urb, Cud, Uh, Uh, Qxu, Qxu, Xu, Xos, Xos, Urb, Rr, Xuc, Xuc, Cud, Xu, Xu, Wwf, Re^Es, Ss, Ss, Xu, Xu, Xu, Xu
Xu, Xu, Uu, Uh, Re, Xu, Xu, Xu, Rr, Cud, Cud, Xu, Xu, Xu, Xos, Urb, Urb, Rr, Rr, Urb^Es, Urb^Es, Cud, Uh, Xu, Xu, Xu, Xos, Urb^Es, Rr, Urb, Rr^Em, Uu^Uf, Uu^Uf, Wwf^Em, Xu, Re^Es, Wwf, Xu, Xu, Xu, Xu, Xu
Xu, Xu, Uu, Uu, Xu, Xu, Xu, Rr, Rr, Cud, 9 Kud, Cud, Urb, Xu, Xol, Xos, Xos, Urb, Urb, Rr, Rr, Urb, Xu, Xu, Xu, Xuc, Xu, Uh, Xu, Rr^Es, Urb, Urb, Rr^Em, Uu^Uf, Xu, Xu, Xu, Wwg, Xu, Xu, Xu, Xu
Xu, Xu, Uu, Xu, Xu, Cud, Rr, Rr, Rr, Cud, Cud, Cud, Uu, Urb, Urb, Xol, Xos, Xos, Xos, Urb, Rr, Urb, Xu, Qxu, Xu, Xuc, Xu, Uh, Xu, Uh, Xu, Xu, Kh, Ch^Em, Ch, Xu, Xu, Wwg, Wwf, Xu, Xu, Xu
Xu, Xu, Uu, Xu, Xu, Xu, Cud, Rr, Rr, Xu, Rr, Urb, Urb, Uu, Uu, Cud, Xos, Xu, Xos, Urb, Cud, Urb, Xu, Qxu, Qxu, Xuc, Uh, Xu, Uh, Xos, Xu, Xu, Xu, Ch, Xu, Xu, Wwf, Wwf, Xu, Wwf, Xu, Xu
Xu, Xu, Re, Xu, Xu, Xu, Xu, Rr, Rr, Cud, Xu, Xu, Xu, Urb, Uu, Urb, Xos, Xu, Xos, Cud, Rr, Cud, Xu, Qxu, Uh, Xos, Cud, Uh, Cud, Xos, Xu, Xu, Wog, Xu, Wwg, Wwf, Xu, Xu, Xu, Wwf, Xu, Xu
Xu, Xu, Rd, Xu, Xu, Xu, Cud, Rr, Xu, Xu, Xos, Xu, Urb, Uh, Uu, Urb, Xos, Xu, Xu, Urb, Rr, Urb, Xu, Uh, Uh, Xos, Urb, Rr, Urb, Xos, Xu, Wog, Wog^Ii, Wog, Wwg, Wwf, Wwf, Xu, Xu, Wwf, Wog, Xu
Xu, Xu, Rd^Es, Xu, Xuc, Xuc, Rr, Cud, Xu, Xos, Xos, Cud, Uu, Uu, Uu, Cud, Xos, Xu, Xu, Urb, Rr, Urb, Xu, Xu, Xu, Uh, Urb, Rr, Urb, Xos, Xu, Wog, Wog, Wog, Wwg, Wwg, Wwf, Xu, Xu, Xu, Xu, Xu
Xu, Xu, Rd, Re^Es, Re, Rr^Pr\, Xuc, Xuc, Xu, Xos, Xos, Uu, Uh, Uu, Xos, Xos, Xu, Xu, Xu, Urb, Rr, Urb, Xu, Xu, Xu, Xos, Urb, Rr, Urb, Xos, Xu, Xu, Wwg, Wwg, Wwg, Wwg, Wwf^Es, Xu, Xu, Xu, Xu, Xu
Xu, Xu, Rd, Xu, Uu, Xuc, Xu, Xu, Xu, Xos, Xos, Uh, Uu, Uh, Xol, Xos, Xu, Xu, Xu, Urb, Cud, Urb, Xu, Xu, Xu, Xos, Urb, Rr, Urb, Xos, Xu, Wwf, Xu, Wwg, Xu, Wwf^Es, Wwf, Xu, Xu, Xu, Xu, Xu
Xu, Xu, Xu, Rd, Uu, Xu, Xu, Xu, Xu, Xos, Xos, Uu, Uu, Uu, Uh, Xol, Xu, Xu, Xu, Cud, Rr, Cud, Uh, Xu, Xol, Xol, Urb^Es, Rr, Urb, Xos, Xu, Xu, Xu, Xu, Xu, Xu, Xu, Re, Re, Xu, Xu, Xu
Xu, Xu, Xu, Xu, Uu, Xu, Xu, Xu, Xu, Xos, Xos, Uu, Uh, Uu, Uu, Urb, Cud, Xu, Rr, Rr^Eb, Rr, Rr^Eb, Uh, Xu, Xu, Urb^Es, Rr, Rr^Es, Urb, Xos, Xu, Xu, Xu, Xu, Xu, Xu, Xu, Xu, Cte, Cte, Xu, Xu
Xu, Xu, Xu, Xu, Uu, Xos, Xos, Xu, Xu, Xu, Xu, Xos, Xos, Urb^Es, Cud, Cud, Rr, Rr, Rr, Rr, Rr, Rr, Uh, Uu, Uh, Xu, Xu, Urb^Es, Xos, Xos, Xu, Xu, Xu, Xu, Xu, Xu, Uh, Xu, Uu, Uu^Es, Uu^Es, Xu
Xu, Xu, Xu, Xu, Xos, Uu, Uu, Xu, Xu, Xu, Uh, Xu, Xu, Xu, Xu, Rr, Rr, Rr, Rr, Rr, Uue^Cov, Rr, Rr, Xu, Uu, Uh, Xu, Xos, Xu, Xu, Uu, Xu, Xu, Xu, 7 Kud, Cud, Uh, Uh, Uu, Uu^Es, Uu, Xu
Xu, Xu, Xu, Xu, Xol, Xol, Uu, Uh, Xos, Qxu, Qxu, Xu, Xu, Xu, Xu, Rr, Rr, Rr, Rr, Uue^Cov, 6 Qxua^Kov, Uue^Cov, Rr, Rr, Rr, Rr^Es, Xu, Xu, Xu, Uh, Uu, Uu, Xu, Xu, Cud, Cud, Uu^Es, Uu, Uu, Xu, Xu, Uu
Xu, Xu, Xu, Xos, Uu, Uu, Uu, Uh, Xos, Qxu, Qxu, Xu, Xu, Xu, Xu, Rr, Rr, Rr, Xu, Uue^Cov, Uue^Cov, Uue^Cov, Rr, Rr, Rr, Rr, Xu, Xu, Xu, Uu, Re^Es, Re^Es, Cte, Cud, Cte, Uu, Re^Es, Re^Es, Xu, Xu, Xu, Xu
Xu, Xu, Xu, Cud, Urb, Rr, Xos, Xos, Uu, Uh, Xu, Xu, Xol, Xol, Cud, Rr, Rr, Xu, Rr, Rr, Rr, Rr, Rr, Rr, Rr, Rr, Cud, Xol, Xol, Xu, Xu, Re^Es, Cte, Cte, Cte, Rd^Es, Uh, Uh, Xu, Xu, Xu, Xu
Xu, Xu, Xu, Urb, Urb, Rr, Urb, Urb, Urb, Uu, Xol, Xos, Urb, Urb, Rr, Cud, Cud, Rr, Rr, Rr, Rr, Rr, Rr, Rr, Cud, Cud, Rr, Urb, Urb, Xos, Xu, Xu, Xu, Cte, Uu, Rd^Es, Uh, Uh, Xu, Xu, Xu, Xu
Xu, Xu, Xos, Xu, Urb, Rr, Urb, Urb, Xuc, Xol, Urb, Urb, Rr, Rr, Urb, Urb, Xos, Xu, Xuc, Rr, Rr, Rr, Xuc, Xu, Xos, Urb, Urb, Rr, Urb, Xos, Xu, Xu, Xu, Xu, Uu, Rd^Es, Xu, Xu, Xu, Xu, Xu, Xu
Xu, Xos, Cud, Cud, Rr, Rr, Urb, Urb, Xuc, Xuc, Urb, Rr, Urb, Urb, Xos, Xos, Xu, Xu, Xuc, Cud, Cud, Cud, Xuc, Xu, Xu, Xos, Urb, Rr, Xuc, Xu, Uh, Rd^Es, Re, Cte, Cte, Re^Es, Xu, Xu, Xu, Xu, Xu, Xu
Xu, Xos, 8 Kud, Cud, Rr, Urb, Urb, Urb, Urb, Cud, Rr, Rr, Urb, Xos, Xos, Xu, Xu, Xu, Xuc, Urb, Rr, Urb, Xuc, Xu, Xu, Xos, Urb, Rr, Rr, Xuc, Re, Re^Es, Uu, Re, Xu, Xu, Xu, Xu, Xu, Xu, Xu, Xu
Xu, Xos, Cud, Cud, Rr, Urb, Rr, Rr, Rr, Rr, Urb, Urb, Uue, Cud, Xos, Xu, Xu, Xu, Xuc, Urb, Rr, Urb, Xuc, Xu, Xu, Xos, Xos, Urb, Urb, Rr, Uu, Uu, Uue, Uh, Xu, Xu, Xu, Xu, Xu, Xu, Xu, Xu
Xu, Xos, Xu, Cud, Urb, Rr, Urb, Urb, Urb, Urb, Urb, Urb, Uue, Uh, Xu, Xu, Xu, Xu, Xuc, 1 Urb, Rr, 5 Urb, Xuc, Xu, Xu, Xu, Xu, Xu, Xu, Urb, Xu, Xu, Xu, Xu, Xu, Xu, Xu, Xu, Xu, Xu, Xu, Xu
Xu, Xos, Xos, Xu, Cud, Urb, Xos, Xos, Xos, Urb, Urb, Uu, Qxe, Qxe, Xue, Xu, Xu, Xu, Xuc, 2 Urb^Es, 3 Rr^Es, 4 Urb^Es, Xuc, Xu, Xu, Xu, Xu, Xu, Xu, Xu, Xu, Xu, Xu, Xu, Xu, Xu, Xu, Xu, Xu, Xu, Xu, Xu
Xu, Xos, Xos, Urb, Xu, Xu, Xu, Xu, Xu, Xos, Xos, Uue, Xue, Uh, Xu, Xu, Xu, Xu, Xuc, Xuc, Uh, Xuc, Xuc, Xu, Xu, Xu, Xu, Xu, Xu, Xu, Xu, Xu, Xu, Xu, Xu, Xu, Xu, Xu, Xu, Xu, Xu, Xu
Xu, Xu, Xu, Xu, Xu, Xu, Xu, Xu, Xu, Xu, Xu, Xu, Xu, Xu, Xu, Xu, Xu, Xu, Xuc, Xom, Uh, Xom, Xuc, Xu, Xu, Xu, Xu, Xu, Xu, Xu, Xu, Xu, Xu, Xu, Xu, Xu, Xu, Xu, Xu, Xu, Xu, Xu
