border_size=1
usage=map

Xu          , Xu          , Xu          , Xu          , Xu          , Xu          , Xu          , Xu          , Xu          , Xu          , Xu          , Xu          , Xu          , Xu          , Xu          , Xu          , Xu          , Xu          , Xu          , Xu          , Xu          , Xu          , Xu          , Xu          , Xu          , Xu          , Xu          , Xu          , Xu          , Xu          , Xu          , Xu          , Xu          , Xu          , Xu          , Xu          , Xu          , Xu          , Xu          , Xu          , Xu          , Xu          , Xu          , Xu          , Xu          , Xu          , Xu          , Xu          , Xu          , Xu          , Xu          , Xu          
Xu          , 9 Kv        , Cv          , Cv          , Cv          , Cv          , Xu          , Xu          , Xu          , Xu          , Cv          , Gg^Efm      , Gg          , Xu          , Xu          , Xu          , Xu          , Xu          , Xu          , Xu          , Xu          , Xu          , Xu          , Rp          , Xu          , Xu          , Re          , Re          , Re          , Re          , Gg          , Mm          , Gs^Fp       , Gg          , Hh          , Gg          , Re          , Gg          , Gs^Fp       , Gg          , Gg          , Gs          , Gs^Fp       , Gs          , Re          , Gg          , Re          , Gg          , Cud         , Cud         , Cud         , Xu          
Xu          , Cv          , Cv          , Cv          , Cv          , Cv          , Xu          , Gg          , Xu          , Xu          , Xu          , Xu          , Cv          , Xu          , Xu          , Xu          , Gg          , Xu          , Xu          , Xu          , Gg^Efm      , Gg          , Gg          , Xu          , Hh          , Gg          , Gg          , Re          , Gg          , Gs^Fp       , Gs^Fp       , Gg          , Gg          , Gg          , Gg          , Re          , Gg          , Re          , Re          , Hh          , Gg          , Gg          , Re          , Hh          , Re          , Gg          , Re          , Gg          , Cud         , Cud         , 6 Kud       , Xu          
Xu          , Cv          , Cv          , Cv          , Cv          , Cv          , Xu          , Gg^Efm      , Xu          , Xu          , Gg          , Gg          , Gg          , Xu          , Gg          , Gg^Efm      , Xu          , Xu          , Gg          , Gg          , Hh          , Hh          , Gs          , Gs          , Gs^Fp       , Re          , Gg          , Hh          , Gg          , Gg^Efm      , Gg          , Re          , Re          , Gs^Fp       , Gs^Fp       , Gg          , Gg          , Cud         , Gg          , Gs          , Gg          , Re          , Re          , Re          , Gg          , Gs^Fp       , Gs          , Re          , Cud         , Cud         , Cud         , Xu          
Xu          , Cv          , Gg^Efm      , Cv          , Gg          , Gg          , Xu          , Xu          , Gg          , Gg^Efm      , Gg          , Cv          , Gg          , Xu          , Xu          , Xu          , Gs^Fp       , Gg^Efm      , Gs^Fp       , Gg          , Gg          , Gg          , Gs          , Gs          , Re          , Re          , Gg          , Gs^Fp       , Gs          , Gs          , Gs          , Hh          , Re          , Gs          , Gs          , Gs          , Re          , Re          , Gs          , Gs          , Gs^Fp       , Hh          , Hh          , Re          , Gs          , Gs          , Hh          , Re          , Re          , Cud         , Cud         , Xu          
Xu          , Gg          , Gg          , Gg          , Hh          , Gs          , Xu          , Gg          , Gg          , Cv          , Gg          , Gg          , Xu          , Xu          , Gg          , Hh          , Hh          , Gg          , Gg          , Gg          , Gg          , Gs^Fp       , Gg          , Gg          , Gg          , Gg          , Gg          , Gg          , Hh          , Gs^Fp       , Gs          , Gg          , Gg          , Gg          , Gs^Fp       , Gs          , Gg          , Gg          , Hh          , Gs^Fp       , Gg          , Hh          , Mm          , Re          , Gs          , Gs          , Re          , Gg          , Re          , Re          , Re          , Xu          
Xu          , Gs^Fp       , Gs^Fp       , Gg          , Gs          , Mm          , Xu          , Cv          , Gg          , Gg          , Xu          , Xu          , Gg          , Gg          , Gs^Fp       , Gg          , Gg          , Gg          , Hh          , Gg          , Mm          , Hh          , Xu          , Gg          , Kud         , Gg          , Xu          , Gg          , Re          , Re          , Gs          , Gs^Fp       , Gg          , Gg          , Re          , Hh          , Gg          , Xu          , Xu          , Xu          , Xu          , Xu          , Xu          , Xu          , Xu          , Xu          , Xu          , Xu          , Xu          , Xu          , Xu          , Xu          
Xu          , Hh          , Gs          , Gs          , Gg          , Gs^Fp       , Xu          , Gg          , Xu          , Xu          , Mm          , Hh          , Gg          , Gg          , Gg          , Gs          , Gs^Fp       , Gg          , Gs^Fp       , Gg          , Xu          , Xu          , Gg          , Gg          , Gg          , Re          , Re          , Xu          , Xu          , Re          , Re          , Gs^Fp       , Gg          , Gs^Fp       , Gg          , Re          , Re          , Gg          , Gg          , Xu          , Xu          , Gs          , Re          , Xu          , Re          , Re          , Gs          , Xu          , Re          , Gs          , Re          , Xu          
Xu          , Gs^Fp       , Gg^Efm      , Gg          , Gg          , Hh          , Xu          , Xu          , Gg          , Ss          , Gs          , Gs          , Gs          , Gg^Efm      , Gg          , Gs          , Gs          , Ss          , Xu          , Xu          , Gg          , Hh          , Gg          , Gg          , Hh          , Re          , Gs^Fp       , Hh          , Gs^Fp       , Xu          , Xu          , Hh          , Re          , Re          , Hh          , Gg          , Gs          , Gs^Fp       , Gg          , Gg          , Re          , Xu          , Xu          , Xu          , Gs          , Cud         , Gg          , Xu          , Re          , Cud         , Re          , Xu          
Xu          , Gg          , Gg          , Cv          , Gg          , Gg          , Gg          , Gg          , Gg          , Hh          , Gs          , Gs          , Gs^Fp       , Hh          , Gg          , Gs          , Xu          , Xu          , Gg          , Hh          , Gg          , Gg          , Gs^Fp       , Gg          , Xu          , Gg          , Gg          , Gg          , Gs          , Gs          , Gs^Fp       , Xu          , Xu          , Mm          , Gg          , Gg          , Gs          , Gs          , Gg          , Re          , Re          , Gs^Fp       , Gs          , Xu          , Xu          , Gs          , Re          , Xu          , Gs          , Gg          , Xu          , Xu          
Xu          , Hh          , Gs          , Gg          , Gg          , Gg^Efm      , Hh          , Gg          , Gg          , Gs^Fp       , Gs          , Gs^Fp       , Gg          , Gg          , Xu          , Xu          , Gs^Fp       , Gs          , Gs^Fp       , Gg          , Gg          , Gg          , Xu          , Xu          , Ss          , Xu          , Xu          , Gg          , Gs          , Hh          , Re          , Re          , Re          , Xu          , Xu          , Gs^Fp       , Gs          , Gs^Fp       , Gg          , Hh          , Re          , Gs^Fp       , Gs          , Mm          , Gg          , Xu          , Xu          , Cud         , Xu          , Xu          , Xu          , Xu          
Xu          , Gs          , Gs          , Gs^Fp       , Gs^Fp       , Gg          , Gg          , Hh          , Gg^Efm      , Gs          , Gs^Fp       , Hh          , Xu          , Xu          , Gs          , Gs^Fp       , Gs          , Gs          , Gg          , Hh          , Gg          , Gg          , Gg          , Ww          , Ww          , Ww          , Ss          , Gg          , Gs^Fp       , Gs          , Gs^Fp       , Re          , Gg          , Hh          , Gs^Fp       , Xu          , Xu          , Gs          , Gg          , Re          , Re          , Gs          , Gs          , Gg          , Gg          , Hh          , Gg          , Xu          , Xu          , Hh          , Hh          , Xu          
Xu          , Gs          , Gs          , Hh          , Gs          , Gs          , Gs^Fp       , Gg          , Gg          , Gs          , Xu          , Xu          , Gs^Fp       , Gg          , Hh          , Gs          , Gg          , Gg          , Gg          , Xu          , Gg          , Gs^Fp       , Gs          , Gs          , Gg^Efm      , Wwf         , Hh          , Gg          , Gs          , Gs          , Gs          , Xu          , Gg          , Gg          , Re          , Gg          , Gg          , Xu          , Xu          , Gg          , Gg          , Gs^Fp       , Hh          , Gs^Fp       , Gg          , Re          , Gg          , Re          , Re          , Xu          , Xu          , Xu          
Xu          , Mm          , Gg          , Gg          , Gs^Fp       , Gs          , Gs          , Gg          , Xu          , Xu          , Hh          , Gg          , Gg          , Gg          , Hh          , Gg          , Gg          , Kv          , Xu          , Xu          , Hh          , Gg          , Hh          , Gs^Fp       , Gg          , Wwf         , Gg          , Hh          , Gs          , Gs          , Gg          , Xu          , Xu          , Kud         , Re          , Gg          , Gg          , Gs^Fp       , Gs^Fp       , Xu          , Xu          , Gg          , Re          , Re          , Gs^Fp       , Re          , Gg          , Hh          , Gs^Fp       , Re          , Re          , Xu          
Xu          , Gs^Fp       , Ss          , Hh          , Gg^Efm      , Gs          , Gs^Fp       , Gg^Efm      , Xu          , Gg          , Gg          , Gs^Fp       , Gg          , Gg          , Gg          , Xu          , Xu          , Xu          , Ss          , Ww          , Wwf         , Gg          , Gg          , Ss          , Wwf         , Wwf         , Wwf         , Gs          , Gg          , Gs^Fp       , Wwf         , Ww          , Ss          , Xu          , Xu          , Xu          , Re          , Gg          , Re          , Re          , Hh          , Xu          , Xu          , Gs^Fp       , Gg          , Gg          , Gs          , Gs          , Gs^Fp       , Re          , Mm          , Xu          
Xu          , Xu          , Xu          , Gg          , Gg          , Gg          , Gg          , Gg          , Gg          , Gg          , Gg          , Gg          , Xu          , Gs^Fp       , Gg          , Gg          , Hh          , Ww          , Ww          , Ww          , Hh          , Wwf         , Wwf         , Wwf         , Gg          , Gg          , Gg          , Wwf         , Wwf         , Wwf         , Gs          , Ww          , Ww          , Ww          , Ss          , Re          , Re          , Hh          , Hh          , Gg          , Re          , Re          , Gs^Fp       , Xu          , Gg^Efm      , Gs          , Gs^Fp       , Gs          , Gs          , Hh          , Gg          , Xu          
Xu          , Rp          , Xu          , Gg          , Gg          , Hh          , Gg          , Gg          , Kv          , Gg          , Gg          , Gg          , Xu          , Gg          , Gg^Efm      , Hh          , Gg          , Gg          , Ss          , Wwf         , Gg          , Gg          , Wwf         , Gs          , 4 Kh        , Gg^Wm       , 3 Kh        , Gg          , Wwf         , Gs^Fp       , Hh          , Wwf         , Gg          , Gg          , Gs          , Gs^Fp       , Gg          , Re          , Gg          , Gg          , Re          , Hh          , Gg          , Xu          , Gg          , Gg          , Gg          , Gs          , Gg          , Gg          , Xu          , Xu          
Xu          , Xu          , Ss          , Mm          , Gs          , Gg          , Gg^Efm      , Gg          , Gg          , Gg          , Gs          , Gg          , Xu          , Gg          , Hh          , Gs          , Gs          , Gs^Fp       , Gs          , Wwf         , Gg          , Gs^Fp       , Wwf         , Gs          , 2 Kh        , Rr          , 1 Kh        , Gg^Efm      , Wwf         , Gs          , Gg          , Wwf         , Gg          , Gs^Fp       , Gs          , Gs^Fp       , Gg          , Gg          , Hh          , Xu          , Re          , Re          , Gg          , Gg          , Gg          , Hh          , Gg          , Gg          , Hh          , Xu          , Rp          , Xu          
Xu          , Hh          , Ss          , Ss          , Gs          , Gs          , Gs          , Gs          , Xu          , Gs          , Gs          , Gs          , Xu          , Gg          , Gg          , Gg          , Gs^Fp       , Gs          , Ww          , Wwf         , Hh          , Gs          , Wwf         , Gg          , Gg          , 5 Kh        , Gs          , Gg          , Wwf         , Ss          , Hh          , Wwf         , Ww          , Gg          , Gg          , Hh          , Gg          , Gs^Fp       , Gg          , Xu          , Gg          , Gg          , Gg          , Khr         , Gg          , Gg          , Gg          , Gg          , Ha          , Xu          , Xu          , Xu          
Xu          , Mm          , Mm          , Gs          , Gs          , Mm          , Ss          , Mm          , Xu          , Hh          , Mm          , Gs          , Gs          , Gs          , Gs          , Gg          , Xu          , Ww          , Ss          , Ww          , Wwf         , Wwf         , Ss          , Wwf         , Wwf         , Gg          , Wwf         , Wwf         , Gg          , Wwf         , Wwf         , Ww          , Ss          , Ww          , Xu          , Gg          , Gg          , Gg          , Aa          , Xu          , Aa          , Ha          , Aa          , Gg          , Aa          , Aa          , Aa^Fpa      , Ha          , Aa          , Aa          , Aa          , Xu          
Xu          , Hh          , Gs          , Gs          , Hh          , Hh          , Ss          , Hh          , Xu          , Mm          , Hh          , Gs          , Gs          , Gs          , Mm          , Xu          , Gs          , Xu          , Xu          , Ww          , Gg          , Gs^Fp       , Gg          , Gg          , Gg          , Wwf         , Gg^Efm      , Gg          , Gs^Fp       , Gg          , Gg          , Ww          , Xu          , Xu          , Aa          , Xu          , Aa^Fpa      , Aa          , Aa^Fpa      , Aa          , Aa          , Aa          , Ha          , Xu          , Aa          , Aa          , Aa          , Aa          , Aa^Fpa      , Ha          , Ms          , Xu          
Xu          , Gs^Fp       , Ss          , Gs          , Gs          , Mm          , Gs^Fp       , Ss          , Gs          , Xu          , Xu          , Gs          , Hh          , Gs^Fp       , Gs          , Gs          , Gs          , Kh          , Gs          , Xu          , Gg          , Gg          , Gs^Fp       , Hh          , Gg          , Wwf         , Ss          , Gg          , Gs          , Hh          , Gg          , Xu          , Aa          , Khr         , Aa          , Aa          , Aa          , Aa          , Aa          , Ha          , Aa          , Ms          , Xu          , Xu          , Ha          , Aa^Fpa      , Aa^Fpa      , Aa          , Aa          , Ha          , Aa          , Xu          
Xu          , Ss          , Hh          , Gs          , Ss          , Gs          , Gs          , Gs          , Gs          , Gs          , Gs          , Xu          , Xu          , Mm          , Hh          , Gs          , Gs          , Gs          , Gs          , Xu          , Gs          , Gg          , Gg          , Gg          , Gg^Efm      , Wwf         , Gg          , Hh          , Gs          , Gs^Fp       , Gg          , Xu          , Aa          , Aa          , Aa          , Aa          , Aa^Fpa      , Ms          , Aa          , Aa          , Xu          , Xu          , Ms          , Aa          , Aa          , Aa          , Aa          , Aa          , Aa          , Aa          , Aa          , Xu          
Xu          , Xu          , Xu          , Mm          , Hh          , Gs          , Gs          , Gs          , Mm          , Hh          , Gs          , Hh          , Mm          , Xu          , Xu          , Mm          , Hh          , Gs          , Gs          , Mm          , Gs          , Gs          , Gs          , Gg          , Ss          , Wwf         , Ww          , Gg          , Gg          , Gg          , Aa          , Aa          , Aa          , Aa          , Ms          , Aa          , Aa          , Aa^Fpa      , Xu          , Xu          , Aa          , Aa          , Aa          , Aa          , Aa^Fpa      , Aa          , Aa          , Aa^Fpa      , Ms          , Aa^Fpa      , Aa^Fpa      , Xu          
Xu          , Mm          , Mm          , Xu          , Xu          , Gs          , Mm          , Gs          , Gs          , Hh          , Gs          , Gs^Fp       , Gs          , Hh          , Ss          , Xu          , Xu          , Gs^Fp       , Ss          , Hh          , Hh          , Gs          , Gs^Fp       , Gs          , Xu          , Ww          , Ss          , Ww          , Xu          , Aa          , Ha          , Aa^Fpa      , Aa          , Ha          , Ha          , Ha          , Xu          , Xu          , Ha          , Aa          , Aa          , Aa^Fpa      , Aa          , Aa          , Aa^Fpa      , Aa          , Aa          , Aa          , Aa          , Aa          , Ha          , Xu          
Xu          , Xu          , Xu          , Xu          , Mm          , Xu          , Xu          , Gs^Fp       , Ss          , Ss          , Ss          , Gs          , Gs          , Gs          , Ss          , Ss          , Mm          , Xu          , Xu          , Mm          , Hh          , Mm          , Gs          , Gs          , Mm          , Xu          , Xu          , Xu          , Aa^Fpa      , Aa          , Ms          , Aa          , Aa          , Ms          , Xu          , Xu          , Aa          , Aa          , Aa          , Ha          , Aa          , Aa          , Aa          , Aa          , Ha          , Ms          , Aa          , Aa          , Chr         , Aa          , Aa          , Xu          
Xu          , Xu          , Gs          , Gs          , Xu          , Gs          , Gs          , Xu          , Xu          , Ss          , Mm          , Mm          , Hh          , Gs          , Gs          , Hh          , Mm          , Ss          , Ss          , Xu          , Xu          , Hh          , Hh          , Hh          , Hh          , Mm          , Gs          , Aa          , Aa          , Aa^Fpa      , Aa          , Ha          , Xu          , Xu          , Aa          , Aa^Fpa      , Aa          , Ha          , Aa          , Aa          , Aa          , Aa^Fpa      , Aa          , Aa          , Xu          , Xu          , Aa          , Aa          , Aa          , Aa          , Ms          , Xu          
Xu          , Gs          , Mm          , Gs          , Xu          , Gs          , Mm          , Gs          , Xu          , Xu          , Xu          , Hh          , Hh          , Gs          , Gs          , Gs          , Gs^Fp       , Hh          , Gs          , Ss          , Gs          , Xu          , Xu          , Mm          , Hh          , Gs          , Gs          , Aa          , Aa          , Ms          , Xu          , Xu          , Aa          , Aa          , Aa          , Aa^Fpa      , Aa          , Aa          , Aa^Fpa      , Ha          , Ms          , Aa          , Xu          , Xu          , Xu          , Xu          , Ha          , Aa^Fpa      , Aa          , Aa          , Ha          , Xu          
Xu          , Gs          , Gs          , Gs          , Xu          , Gs          , Gs          , Gs          , Xu          , Mm          , Mm          , Xu          , Xu          , Mm          , Ss          , Gs          , Gs          , Gs          , Mm          , Gs          , Gs          , Gs          , Hh          , Xu          , Xu          , Gs          , Gs          , Gs          , Xu          , Xu          , Aa          , Aa          , Aa          , Ha          , Aa          , Aa          , Aa          , Aa          , Aa          , Ms          , Xu          , Xu          , Xu          , Xu          , Xu          , Xu          , Ha          , Aa          , Aa          , Ha          , Aa^Fpa      , Xu          
Xu          , Xu          , Xu          , Xu          , Xu          , Xu          , Xu          , Xu          , Xu          , Xu          , Xu          , Xu          , Xu          , Xu          , Xu          , Gs          , Gs          , Ss          , Hh          , Ss          , Gs          , Ss          , Hh          , Mm          , Gs          , Gs          , Kh          , Gs          , Aa          , Aa^Fpa      , Aa          , Aa          , Aa          , Aa          , Aa          , Ha          , Aa          , Aa          , Xu          , Xu          , Xu          , Xu          , Xu          , Xu          , Ai          , Xu          , Ms          , Aa          , Ha          , Ms          , Ms          , Xu          
Xu          , Gs^Fp       , Gs          , Gs          , Hh          , Hh          , Gs          , Ss          , Ss          , Gs^Fp       , Mm          , Hh          , Ss          , Ss          , Hh          , Mm          , Gs          , Gs          , Gs          , Gs          , Gs          , Gs          , Gs          , Gs          , Gs          , Gs          , Gs          , Gs          , Aa          , Aa          , Aa          , Aa          , Aa^Fpa      , Aa^Fpa      , Aa^Fpa      , Ms          , Xu          , Xu          , Ms          , Ms          , Xu          , Xu          , Ai          , Ai          , Chr         , Xu          , Aa^Fpa      , Aa          , Aa          , Ha          , Aa          , Xu          
Xu          , Ch          , Ch          , Gs          , Gs          , Mm          , Gs          , Gs          , Gs          , Gs          , Gs          , Hh          , Mm          , Ss          , Gs          , Gs^Fp       , Gs          , Gs          , Hh          , Gs          , Gs          , Gs          , Mm          , Hh          , Gs          , Gs          , Aa          , Aa          , Ha          , Aa          , Aa          , Aa^Fpa      , Ms          , Ha          , Xu          , Xu          , Xu          , Ms          , Xu          , Xu          , Ai          , Ai          , Ai          , Ai          , Ai          , Xu          , Aa          , Aa          , Chr         , Aa          , Aa          , Xu          
Xu          , Ch          , Ch          , Ch          , Ch          , Gs          , Gs^Fp       , Hh          , Mm          , Gs          , Gs          , Gs          , Gs          , Gs          , Ch          , Gs          , Ss          , Mm          , Mm          , Gs^Fp       , Gs          , Gs          , Gs          , Gs          , Hh          , Gs          , Aa          , Aa          , Ha          , Ms          , Aa^Fpa      , Ha          , Xu          , Xu          , Xu          , Xu          , Xu          , Xu          , Ai          , Ai          , Chr         , Ai          , Ai          , Ai          , Xu          , Xu          , Chr         , Chr         , Chr         , Chr         , Chr         , Xu          
Xu          , 7 Kh        , Ch          , Ch          , Ch          , Gs          , Hh          , Mm          , Hh          , Gs          , Hh          , Gs          , Gs^Fp       , Gs          , Gs          , Gs          , Ss          , Hh          , Hh          , Hh          , Gs          , Gs          , Gs^Fp       , Gs          , Gs          , Mm          , Xu          , Aa^Fpa      , Ms          , Ha          , Xu          , Xu          , Xu          , Xu          , Xu          , Xu          , Ai          , Ai          , Ai          , Ai          , Ai          , Ai          , Xu          , Xu          , Ai          , Xu          , Chr         , Chr         , Chr         , Chr         , Chr         , Xu          
Xu          , Ch          , Ch          , Ch          , Ch          , Gs          , Gs          , Hh          , Ss          , Ss          , Ss          , Mm          , Gs          , Gs          , Hh          , Hh          , Mm          , Ss          , Ss          , Ss          , Ss          , Gs          , Mm          , Hh          , Xu          , Xu          , Rp          , Xu          , Xu          , Xu          , Xu          , Xu          , Xu          , Xu          , Xu          , Xu          , Chr         , Ai          , Ai          , Ai          , Xu          , Xu          , Xu          , Xu          , Ai          , Xu          , Chr         , Chr         , 8 Khr       , Chr         , Chr         , Xu          
Xu          , Xu          , Xu          , Xu          , Xu          , Xu          , Xu          , Xu          , Xu          , Xu          , Xu          , Xu          , Xu          , Xu          , Xu          , Xu          , Xu          , Xu          , Xu          , Xu          , Xu          , Xu          , Xu          , Xu          , Xu          , Xu          , Xu          , Xu          , Xu          , Xu          , Xu          , Xu          , Xu          , Xu          , Xu          , Xu          , Xu          , Xu          , Xu          , Xu          , Xu          , Xu          , Xu          , Xu          , Xu          , Xu          , Xu          , Xu          , Xu          , Xu          , Xu          , Xu          
