border_size=1
usage=map

Cud         , Cud         , Cud         , Cud         , Cud         , Cud         , Hh          , Hh          , Hh          , Gg          , Mm^Xm       , Mm^Xm       , Mm^Xm       , Mm^Xm       , Mm^Xm       , Chs         , Chs         , Chs         , Chs         , Chs         , Chs         , Hh          , Mm          , Mm          , Hh          , Mm          , Gg          , Gg          
Cud         , Cud         , Cud         , Cud         , Cud         , Cud         , Gg          , Gg          , Hh          , Gg          , Mm^Xm       , Mm^Xm       , Mm^Xm       , Mm^Xm       , Mm^Xm       , Chs         , 8 Khs       , Chs         , Chs         , Chs         , Chs         , Gg          , Hh          , Mm          , Hh          , Gg          , Mm          , Gg          
Cud         , Cud         , 9 Kud       , Cud         , Cud         , Gg          , Cud         , Gg          , Gg          , Gs^Ft       , Hh          , Mm^Xm       , Mm^Xm       , Mm^Xm       , Mm^Xm       , Chs         , Chs         , Chs         , Chs         , Chs         , Chs         , Gg          , Gg          , Hh          , Gg          , Gg          , Gg          , Gg          
Mm^Xm       , Cud         , Cud         , Cud         , Cud         , Cud         , Cud         , Gg          , Gs^Ft       , Gs          , Gg^Efm      , Mm          , Hh          , Mm^Xm       , Mm^Xm       , Mm^Xm       , Mm^Xm       , Chs         , Chs         , Chs         , Gg          , Gg          , Gg          , Ds          , Gs          , Gs^Ft       , Hh          , Hh          
Mm^Xm       , Mm^Xm       , Mm^Xm       , Cud         , Cud         , Gg          , Gg          , Gg          , Gg          , Gs          , Gg          , Gs^Ft       , Gs          , Gs          , Gg          , Mm^Xm       , Mm^Xm       , Mm^Xm       , Gg          , Gg          , Gg          , Hh          , Gg^Fet      , Gs          , Gs^Ft       , Gs^Ft       , Mm          , Gg          
Mm^Xm       , Mm^Xm       , Mm^Xm       , Mm^Xm       , Mm^Xm       , Cud         , Gs          , Gs          , Hh          , Gs^Ft       , Hh          , Gg          , Gs          , Gs^Ft       , Gg          , Hh          , Mm^Xm       , Mm^Xm       , Gs^Ft       , Gg          , Ds          , Mm          , Hh          , Gg          , Gs          , Ds          , Gg          , Gg          
Mm^Xm       , Mm^Xm       , Mm^Xm       , Mm^Xm       , Mm^Xm       , Mm^Xm       , Mm^Xm       , Gs          , Mm          , Gs^Ft       , Gg          , Gs          , Gg^Fet      , Gs^Ft       , Mm          , Hh          , Mm^Xm       , Mm^Xm       , Gs^Ft       , Hh          , Gs          , Gs          , Gs^Ft       , Gs^Ft       , Gs          , Gs^Ft       , Gs^Ft       , Gg          
Mm^Xm       , Mm^Xm       , Mm^Xm       , Mm^Xm       , Mm^Xm       , Mm^Xm       , Mm^Xm       , Mm^Xm       , Mm^Xm       , Gg          , Gg          , Gs^Ft       , Gg          , Gs          , Gs^Ft       , Hh          , Mm^Xm       , Mm^Xm       , Gs^Ft       , Hh          , Gg^Efm      , Gs^Ft       , Gs^Ft       , Ds          , Gg          , Gs^Ft       , Gs^Ft       , Gg          
Mm^Xm       , Mm^Xm       , Mm^Xm       , Mm^Xm       , Uu          , Uu          , Uu          , Mm^Xm       , Mm^Xm       , Mm^Xm       , Mm          , Gs^Ft       , Gg          , Gg^Efm      , Gg          , Gg          , Mm^Xm       , Mm^Xm       , Gg          , Gs^Ft       , Ds          , Gs          , Gg^Fet      , Gg          , Gs^Ft       , Ds          , Hh          , Gg          
Mm^Xm       , Mm^Xm       , Chr         , Gg          , Gg          , Rr          , Re          , Uu          , Mm^Xm       , Mm^Xm       , Hh          , Hh          , Gs          , Gg          , Gg          , Gg          , Mm^Xm       , Mm^Xm       , Mm^Xm       , Gg          , Gg          , Gg          , Gg          , Gs          , Gg          , Gg^Efm      , Hh          , Hh          
Mm^Xm       , Gg          , Gg          , Gg          , Chr         , Re          , Chr         , Re          , Mm^Xm       , Mm^Xm       , Gg          , Gs          , Gg          , Gg          , Gg          , Gg          , Gg          , Mm^Xm       , Mm^Xm       , Mm^Xm       , Mm^Xm       , Gs^Ft       , Gs^Ft       , Gg          , Gs^Ft       , Gs          , Mm          , Gg          
Mm^Xm       , Uu          , Re^Uf       , Gg          , Re          , Re          , Re          , Gg          , Mm^Xm       , Mm^Xm       , Mm^Xm       , Gg          , Gg          , Gg          , Gs^Ft       , Gg          , Gg          , Gg          , Gg          , Mm^Xm       , Mm^Xm       , Mm^Xm       , Gg          , Gs^Ft       , Gg          , Hh          , Gg          , Gg          
Mm^Xm       , Uu          , Gg^Efm      , Gg^Fet      , Gg          , Re          , Gs          , Uu          , Mm^Xm       , Mm^Xm       , Gg          , Mm^Xm       , Mm^Xm       , Gg          , Gs^Ft       , Gs^Ft       , Gs          , Gs^Ft       , Gg          , Gg          , Gs^Ft       , Gg          , Gg^Efm      , Ds          , Gs          , Gg          , Ds          , Gg          
Mm          , Uu          , Re^Uf       , Gg          , Kv          , Gg          , Gs          , Uu          , Mm^Xm       , Mm^Xm       , Gg          , Gg          , Gg          , Mm^Xm       , Mm^Xm       , Gg          , Gg          , Gs^Ft       , Gs^Ft       , Gs          , Gs          , Hh          , Hh          , Gg          , Gs^Ft       , Gs^Ft       , Hh          , Gg          
Mm          , Uu          , Re          , Gg          , Re          , Re          , Gg          , Uu          , Mm^Xm       , Mm^Xm       , Gg          , Rr          , Gg          , Gg          , Gg          , Mm^Xm       , Mm^Xm       , Gg          , Gg          , Gs^Ft       , Gg          , Gs^Ft       , Mm          , Gs          , Gs^Ft       , Gs^Ft       , Hh          , Gg          
Mm          , Uu          , Gg          , Re          , Re          , Gg^Fet      , Re^Uf       , Uu          , Mm^Xm       , Mm^Xm       , Gg          , Gg          , Gg          , Gg          , Gg          , Gg          , Gg          , Mm^Xm       , Mm^Xm       , Gg          , Gg          , Gs^Ft       , Gs^Ft       , Ds          , Gs          , Gg          , Gs^Ft       , Gg          
Mm          , Uu          , Re          , Gg          , Kv          , Gg          , Re          , Uu          , Mm^Xm       , Mm^Xm       , Mm^Xm       , Uu          , Gg          , Gs^Fp       , Gg          , Ss          , Gg          , Gg          , Gg          , Mm^Xm       , Mm^Xm       , Gg^Fet      , Gs^Ft       , Gg          , Hh          , Gs^Ft       , Ds          , Gg          
Mm          , Uu          , Gg          , Re          , Gg          , Re          , Re          , Uu          , Mm^Xm       , Mm^Xm       , Mm^Xm       , Mm^Xm       , Mm^Xm       , Gg          , Gg          , Gg          , Gg          , Gg          , Gg          , Gg          , Gg          , Mm^Xm       , Gg          , Gg          , Gs^Ft       , Gs^Ft       , Gs^Ft       , Gg          
Mm          , Gg          , Gg          , Gg          , Gg          , Gg          , Gg          , Uu          , Mm^Xm       , Mm^Xm       , Mm^Xm       , Mm^Xm       , Mm^Xm       , Mm^Xm       , Mm^Xm       , Gg          , Gg          , Gg^Efm      , Gg          , Gg          , Mm          , Gg          , Ds          , Gg          , Gs          , Gs          , Hh          , Gg          
Gg          , Cv          , Gg          , Cv          , Gg          , Cv          , Gg          , Mm^Xm       , Mm^Xm       , Mm^Xm       , Gg          , Hh          , Hh          , Mm^Xm       , Mm^Xm       , Mm^Xm       , Mm^Xm       , Gg          , Gg          , Gg          , Aa          , Gg          , Gg          , Hh          , Gs^Ft       , Gg^Efm      , Gs^Ft       , Gg          
Gg          , Gg          , Gg          , Gg          , Gg          , Gg          , Gg          , Mm^Xm       , Gg          , Mm          , Gg          , Gg          , Gs^Ft       , Gs^Ft       , Hh          , Mm^Xm       , Mm^Xm       , Mm^Xm       , Mm^Xm       , Gg          , Gg          , Gg          , Gs^Ft       , Hh          , Gg          , Gg          , Hh          , Gg          
Hh          , Gg          , Gs          , Gg          , Hh          , Gg          , Gg          , Gs^Ft       , Gg          , Gs          , Hh          , Gs^Ft       , Gs^Ft       , Gs^Ft       , Mm          , Gs          , Gs          , Mm^Xm       , Mm^Xm       , Mm^Xm       , Mm^Xm       , Gg          , Ce          , Gg          , Ce          , Gg          , Ce          , Gg          
Mm          , Hh          , Gg          , Gg          , Gs^Ft       , Gg          , Gs^Ft       , Gg          , Gs^Ft       , Gs          , Gs          , Gs^Ft       , Gg          , Gs^Ft       , Hh          , Hh          , Gs^Ft       , Gg          , Gs^Ft       , Mm^Xm       , Mm^Xm       , Mm^Xm       , Ce          , Ce          , 7 Ke        , Ce          , Ce          , Ce          
Mm          , Gs^Ft       , Gg          , Gg          , Gg          , Gg^Efm      , Gs^Ft       , Gs^Ft       , Mm          , Gs^Ft       , Gs^Ft       , Gg          , Gg          , Gs          , Gg^Efm      , Gs          , Gs^Ft       , Gs^Ft       , Gs^Ft       , Mm          , Gs^Ft       , Mm^Xm       , Ce          , Ce          , Ce          , Ce          , Ce          , Ce          
Hh          , Hh          , Gg          , Gs^Ft       , Gg          , Gg          , Gs^Ft       , Hh          , Gs^Ft       , Gs^Ft       , Gg          , Gg          , Gg          , Hh          , Gg          , Gg          , Gg          , Gs^Ft       , Gs          , Gs^Ft       , Gg          , Gg          , Gg          , Ce          , Gg          , Ce          , Gg          , Ce          
Gg          , Gg          , Gg^Efm      , Gs^Ft       , Gs          , Gg          , Gg          , Gs^Ft       , Gg^Efm      , Gg          , Mm^Xm       , Mm^Xm       , Mm^Xm       , Gg          , Gs^Ft       , Gg          , Mm          , Gs          , Gs^Ft       , Gs          , Gs^Ft       , Gg          , Gs^Ft       , Gg          , Gg          , Gs          , Hh          , Gg          
Gg          , Gg          , Gs          , Gg          , Gs          , Gs^Ft       , Gg          , Gg          , Mm^Xm       , Mm^Xm       , Mm^Xm       , Mm^Xm       , Mm^Xm       , Mm^Xm       , Mm^Xm       , Hh          , Hh          , Gs^Ft       , Gs^Ft       , Gs^Ft       , Gs^Ft       , Gs          , Gg          , Hh          , Gs          , Gs^Ft       , Gs^Ft       , Hh          
Gg          , Gg          , Gg^Efm      , Gg          , Gg          , Gg          , Mm^Xm       , Mm^Xm       , Mm^Xm       , Mm^Xm       , Gg          , Hh          , Gg          , Mm^Xm       , Mm^Xm       , Mm^Xm       , Mm^Xm       , Gs^Ft       , Gg          , Hh          , Hh          , Gs^Ft       , Gs          , Gg^Efm      , Gs^Ft       , Gg          , Gs^Ft       , Hh          
Gg          , Gg          , Gs^Fp       , Gs^Fp       , Gs^Fp       , Gg          , Mm^Xm       , Mm^Xm       , Gs^Fp       , Hh          , Hh          , Gg          , Gg          , Gg          , Hh          , Mm^Xm       , Mm^Xm       , Mm^Xm       , Mm^Xm       , Hh          , Hh          , Gs^Ft       , Gs          , Gs^Ft       , Mm          , Gg          , Gg          , Hh          
Gg          , Gs          , Gs^Fp       , Gs          , Gs          , Gg          , Gg          , Gs^Fp       , Gs^Fp       , Mm          , Hh          , Gs^Fp       , Gg          , Gs^Fp       , Gs^Fp       , Hh          , Hh          , Mm^Xm       , Mm^Xm       , Mm^Xm       , Mm^Xm       , Uu          , Uu          , Gs^Ft       , Gs          , Gs^Ft       , Uu          , Uu          
Gg          , Gg          , Gg          , Gs          , Hh          , Gg^Efm      , Hh          , Gs          , Gs          , Mm          , Gg          , Gg          , Gs^Fp       , Gg          , Gg^Efm      , Gs^Fp       , Gg          , Gg          , Hh          , Mm^Xm       , Mm^Xm       , Uu          , Cud         , Uu          , Uu          , Uu          , Cud         , Uu          
Gg          , Gg^Efm      , Hh          , Gg          , Gg          , Mm          , Gg          , Gs          , Gg          , Gg^Efm      , Gg          , Gg          , Gs^Fp       , Gs^Fp       , Gs^Fp       , Gs          , Gg          , Gg          , Gg          , Mm^Xm       , Mm^Xm       , Uu          , Uu          , Uu          , Cud         , Uu          , Uu          , Uu          
Gs^Fp       , Hh          , Hh          , Gs          , Gg          , Gg          , Gg          , Gg          , Mm^Xm       , Gg          , Gg          , Gg          , Gs^Fp       , Gs^Fp       , Gs^Fp       , Gs          , Gg          , Gg          , Hh          , Mm^Xm       , Mm^Xm       , Uu          , Uu^Uf       , Uu          , Uu          , Uu          , Uu          , Uh          
Gs^Fp       , Gs^Fp       , Hh          , Gg          , Gs          , Gg          , Hh          , Mm^Xm       , Mm^Xm       , Gg          , Gg          , Gg          , Gg          , Gg          , Gs          , Gs          , Gg          , Gg          , Hh          , Mm^Xm       , Mm^Xm       , Uu          , Uu          , Uu          , Uu          , Uu          , Uu^Uf       , Uu          
Gs^Fp       , Gs          , Hh          , Gg          , Gs          , Hh          , Hh          , Mm^Xm       , Mm^Xm       , Gg          , Gg          , Gs          , Gs          , Gg          , Gg^Wm       , Gg          , Gg^Efm      , Hh          , Hh          , Mm^Xm       , Mm^Xm       , Uu          , Uh          , Uh          , Uu          , Uu          , Uu          , Uh          
Gs^Fp       , Gs^Fp       , Gg          , Gg          , Mm          , Gs^Fp       , Hh          , Mm^Xm       , Mm^Xm       , Gs^Fp       , Gs^Fp       , Gg          , Gg          , Gs          , Gg          , Gs          , Gg          , Gg          , Gg          , Mm^Xm       , Mm^Xm       , Uh          , Uh          , Uu          , Uu          , Uu          , Uh          , Uh          
Gg          , Gg          , Mm          , Gg          , Gs          , Gs^Fp       , Hh          , Mm^Xm       , Md^Xm       , Gs^Fp       , Gs^Fp       , Gg          , Gg          , Gg          , Gg          , Gg          , Gg          , Gg          , Gs^Fp       , Mm^Xm       , Mm^Xm       , Uu          , Uu          , Uu          , Uu^Uf       , Uh          , Uu          , Uh          
Hh          , Gg          , Gg          , Gg          , Gs^Fp       , Gs^Fp       , Md^Xm       , Md^Xm       , Md^Xm       , Gs^Fp       , Gs^Fp       , Gg          , Gg          , 5 Kh        , Gg          , 4 Kh        , Gg          , Gg          , Gs^Fp       , Md^Xm       , Md^Xm       , Uu          , Gs^Ft       , Uu          , Uu          , Uu          , Gs^Ft       , Uu          
Hh          , Hh          , Gs          , Gg          , Mm          , Gs^Fp       , Md^Xm       , Md^Xm       , Md^Xm       , Gs          , Gs          , Gg          , Gs          , Gg          , Rr          , Gg          , Gs          , Gs          , Gs          , Md^Xm       , Md^Xm       , Uu          , Uu          , Uu          , Gs^Ft       , Uu          , Uu          , Uu          
Hh          , Hh          , Gg          , Gg          , Gg          , Mm          , Md^Xm       , Md^Xm       , Md^Xm       , Gs          , Gs          , Ds          , 2 Kh        , Gs          , Gs          , Gs          , 3 Kh        , Gg          , Gs          , Md^Xm       , Md^Xm       , Uh          , Uh          , Uu          , Uu          , Uu          , Uh          , Uh          
Ch          , Gg          , Ch          , Gg          , Ch          , Mm          , Md^Xm       , Md^Xm       , Md^Xm       , Ds          , Gs          , Gs          , Gs          , Gs          , 1 Kh        , Gs          , Gs          , Gs          , Gs          , Md^Xm       , Md^Xm       , Uu          , Uu          , Uu          , Ce          , Uu          , Uu          , Uu          
Ch          , Ch          , Ch          , Ch          , Ch          , Ch          , Md^Xm       , Md^Xm       , Md^Xm       , Ds          , Dd          , Dd          , Dd          , Dd          , Dd          , Dd          , Dd          , Dd          , Dd          , Md^Xm       , Md^Xm       , Uu          , Ce          , Uu          , Uu          , Uu          , Ce          , Uu          
Ch          , Ch          , Ch          , 6 Kh        , Ch          , Ch          , Md^Xm       , Md^Xm       , Md^Xm       , Dd          , Ds          , Dd          , Dd          , Dd          , Dd          , Dd          , Dd          , Ds          , Ds          , Md^Xm       , Md^Xm       , Uu          , Uu          , Uu          , Ce          , Uu          , Uu          , Uu          
Ch          , Ch          , Ch          , Ch          , Ch          , Ch          , Md^Xm       , Md^Xm       , Md^Xm       , Md          , Md          , Md          , Md          , Hd          , Hd          , Hd          , Md          , Md          , Md          , Md^Xm       , Md^Xm       , Uu          , Uu          , Uu          , Uu          , Uu          , Uu          , Uu          
