border_size=1
usage=map

Xu          , Xu          , Xu          , Xu          , Xu          , Xu          , Xu          , Xu          , Xu          , Xu          , Xu          , Xu          , Xu          , Xu          , Xu          , Xu          , Xu          , Xu          , Xu          , Xu          , Xu          , Xu          , Xu          , Xu          , Xu          , Xu          , Xu          , Xu          , Xu          , Xu          , Xu          , Xu          , Xu          , Xu          , Xu          , Xu          , Xu          , Xu          , Xu          , Xu          , Xu          , Xu          
Xu          , 8 Kud       , Cud         , Cud         , Cud         , Cud         , Xu          , Xu          , Gg          , Gg          , Gg          , Xu          , Ai          , Ds          , Ss          , Xu          , Xu          , Xu          , Xu          , Cud         , Xu          , Chs         , Gg^Efm      , Gg          , Dd^Dc       , Xu          , Gg          , Gg          , Gg          , Gs^Fp       , Gg          , Gg          , Gg          , Xu          , Hh          , Hh          , Wwf         , Chw         , Chw         , 6 Khw       , Chw         , Xu          
Xu          , Cud         , Cud         , Cud         , Cud         , Cud         , Xu          , Xu          , Gg          , Hh          , Gg          , Hh          , Xu          , Xu          , Uu          , Xu          , Xu          , Xu          , Xu          , Cud         , Xu          , Gg          , Gg          , Gg          , Gg          , Xu          , Gg          , Cv          , Gg          , Ha          , Gg          , Cud         , Gg          , Xu          , Gg          , Ss          , Wwf         , Chw         , Chw         , Chw         , Chw         , Xu          
Xu          , Cud         , Cud         , Cud         , Cud         , Gg          , Xu          , Xu          , Xu          , Gg          , Xu          , Xu          , Re^Uf       , Ww          , Xu          , Xu          , Ss          , Xu          , Xu          , Xu          , Gg          , Hh          , Gs^Fp       , Gg^Efm      , Gs^Fp       , Xu          , Gg          , Gs          , Gg          , Hh          , Gg          , Gs          , Gg          , Xu          , Gs^Ft       , Gs          , Wwf         , Chw         , Wwf         , Chw         , Wwf         , Xu          
Xu          , Cud         , Cud         , Gg          , Gg          , Gg          , Ss          , Xu          , Xu          , Xu          , Hh          , Mm          , Xu          , Xu          , Ai          , Ds          , Xu          , Uu          , Xu          , Xu          , Gg          , Gg          , Gs          , Gg          , Gg          , Xu          , Gg          , Hh          , Gg          , Uu          , Gg          , Ss          , Gg          , Xu          , Gg          , Wwf         , Ww          , Wwf         , Gg^Efm      , Wwf         , Wwf         , Xu          
Xu          , Gg          , Wwf         , Gg          , Gg          , Gs^Fp       , Mm          , Xu          , Ds          , Ai          , Xu          , Xu          , Mm          , Hh          , Xu          , Xu          , Mm          , Ww          , Xu          , Gg          , Gg          , Chr         , Gs          , Gs          , Gg          , Xu          , Hh          , Gg          , Xu          , Ss          , Xu          , Gg          , Xu          , Xu          , Ww          , Wwf         , Wwf         , Wwf         , Gs^Ft       , Gg          , Wwf         , Xu          
Xu          , Gs^Fp       , Gs^Fp       , Wwf         , Wwf         , Hh          , Hh          , Xu          , Ss          , Xu          , Ww          , Re^Uf       , Xu          , Xu          , Ai          , Hh          , Xu          , Xu          , Gg          , Gs^Fp       , Gs^Fp       , Gs          , Gs          , Ss          , Gg          , Xu          , Xu          , Xu          , Gg          , Xu          , Rr          , Xu          , Wo          , Xu          , Hh          , Wwf         , Wwf         , Hh          , Gs          , Ss          , Wwf         , Xu          
Xu          , Hh          , Gs          , Gs^Fp       , Wwf         , Gg^Efm      , Wwf         , Xu          , Xu          , Uu          , Xu          , Xu          , Ss          , Ds          , Xu          , Xu          , Xu          , Xu          , Gg          , Gg          , Gs          , Gg          , Hh          , Gg          , Ss          , Xu          , Gg^Efm      , Gg^Efm      , Gg          , Rr          , Gg^Efm      , Xu          , Wo          , Xu          , Ww          , Wwf         , Wwf         , Hh          , Gg          , Gg^Fet      , Wwf         , Xu          
Xu          , Gs          , Gs^Fp       , Gs          , Gg          , Wwf         , Gg          , Wwf         , Wwf         , Xu          , Xu          , Uu          , Xu          , Xu          , Gg^Efm      , Xu          , Xu          , Xu          , Gg          , Cv          , Gs          , Gs          , Gg          , Gg^Efm      , Xu          , Xu          , Gg          , Gg^Efm      , Rr          , Rr          , Gg^Efm      , Xu          , Xu          , Xu          , Ww          , Wwf         , Wwf         , Gs^Ft       , Gs          , Gg          , Chw         , Xu          
Xu          , Mm          , Hh          , Gs          , Gg          , Gs^Fp       , Gg          , Wwf         , Gs^Fp       , Wwf         , Wwf         , Xu          , Xu          , Gg          , Gg^Efm      , Xu          , Xu          , Xu          , Ss          , Gs          , Gs          , Chw         , Gg          , Ss          , Xu          , Gg          , Gg          , Rr          , Gg          , Gg          , Gg          , Xu          , Gs          , Gg          , Gg^Fet      , Wwf         , Wwf         , Gg          , Wwf         , Wwf         , Gg          , Xu          
Xu          , Xu          , Xu          , Hh          , Gg          , Wwf         , Wwf         , Hh          , Mm          , Wwf         , Gg^Efm      , Wwf         , Wwf         , Xu          , Xu          , Xu          , Xu          , Xu          , Hh          , Gg          , Hh          , Gg          , Gg          , Xu          , Gg          , Gg          , Gg          , Rr          , Gg          , Gg^Efm      , Xu          , Xu          , Gg          , Gs          , Gs^Ft       , Wwf         , Ww          , Wwf         , Wwf         , Gg          , Gs          , Xu          
Xu          , Wwf         , Wwf         , Xu          , Wwf         , Wwf         , Gg          , Gs          , Gs^Fp       , Wwf         , Ss          , Gs^Fp       , Gs          , Wwf         , Wwf         , Xu          , Xu          , Xu          , Hh          , Gg^Efm      , Gg          , Gs^Fp       , Gs^Fp       , Xu          , Gg^Efm      , Gg^Efm      , Rr          , Rr          , Gg^Efm      , Gg^Efm      , Xu          , Mm          , Hh          , Gg          , Wwf         , Wwf         , Wwf         , Wwf         , Gs^Ft       , Wwf         , Wwf         , Xu          
Xu          , Xu          , Xu          , Xu          , Xu          , Hh          , Gs          , Gs^Fp       , Wwf         , Wwf         , Hh          , Gs^Fp       , Gs          , Hh          , Wwf         , Gs          , Gs          , Xu          , Gg          , Gg          , Gg          , Gg          , Gg          , Xu          , Gg^Efm      , Gg          , Rr          , Gg          , Gg          , Gg          , Xu          , Gg          , Ss          , Wwf         , Wwf         , Wwf         , Gs^Ft       , Gg^Efm      , Gg          , Gg          , Ss          , Xu          
Xu          , Xu          , Xu          , Mm          , Mm          , Xu          , Wwf         , Wwf         , Gs^Fp       , Gg^Efm      , Gs          , Gs          , Gs^Fp       , Gg          , Wwf         , Gs^Fp       , Gs^Fp       , Xu          , Gg          , Cv          , Gs          , Cv          , Gg          , Xu          , Gg          , Gg          , Rr          , Gg          , Xu          , Xu          , Gg          , Gg          , Gg^Efm      , Wwf         , Wwf         , Hh          , Gs          , Gg          , Mm          , Hh          , Xu          , Xu          
Xu          , Xu          , Xu          , Xu          , Xu          , Xu          , Xu          , Hh          , Wwf         , Gs          , Gs^Fp       , Gs          , Wwf         , Wwf         , Gg^Efm      , Gs          , Gs^Fp       , Xu          , Gg          , Gs          , Gs          , Gs          , Gg          , Xu          , Gs          , Rr          , Gs          , Gg          , Xu          , Hh          , Gg          , Gs^Ft       , Wwf         , Wwf         , Wwf         , Gg          , Gs          , Gs          , Xu          , Xu          , Wwf         , Xu          
Xu          , Xu          , Xu          , Xu          , Xu          , Xu          , Xu          , Xu          , Xu          , Gs          , Gs          , Gs          , Wwf         , Hh          , Gg          , Wwf         , Wwf         , Xu          , Gg          , Hh          , Gg          , Hh          , Gg          , Xu          , Gs          , Rr          , Gs          , Gs          , Xu          , Hh          , Gg          , Wwf         , Wwf         , Wwf         , Gg          , Gs^Ft       , Gg          , Hh          , Xu          , Gg^Efm      , Gs          , Xu          
Xu          , Xu          , Xu          , Xu          , Xu          , Gg          , Xu          , Xu          , Gg          , Xu          , Xu          , Gs^Fp       , Wwf         , Mm          , Wwf         , Wwf         , Xu          , Xu          , Gs^Fp       , Gg          , Mm          , Gg^Efm      , Gg          , Xu          , Xu          , Rr          , Gs          , Gs          , Xu          , Hh          , Gg          , Wwf         , Wwf         , Gs^Ft       , Gg          , Gg          , Xu          , Xu          , Xu          , Xu          , Xu          , Xu          
Xu          , Xu          , Xu          , Gg          , Xu          , Xu          , Gg          , Gg          , Gg          , Gg          , Xu          , Xu          , Xu          , Hh          , Xu          , Ss          , Xu          , Gg          , Gg          , Gg          , Wwf         , Hh          , Gg          , Wwf         , Xu          , Gs          , Xu          , Gs          , Xu          , Gg          , Gs^Ft       , Wwf         , Wwf         , Gg          , Hh          , Hh          , Xu          , Xu          , Xu          , Xu          , Xu          , Xu          
Xu          , Gg          , Xu          , Xu          , Gs          , Gg          , Chw         , Gg          , Xu          , Xu          , Wwf         , Wwf         , Wwf         , Xu          , Wwf         , Xu          , Gg          , Gg          , Wwf         , Wwf         , Gg          , Wwf         , Wwf         , Wwf         , Gg          , Xu          , Mm          , Xu          , Gg^Efm      , Gg          , Wwf         , Wwf         , Wwf         , Gg          , Xu          , Xu          , Chs         , Khs         , Chs         , Xu          , Xu          , Xu          
Xu          , Xu          , Gg          , Gs          , Gg^Efm      , Gg          , Gg          , Gg          , Xu          , Wwf         , Wo          , Wo          , Wwf         , Wwf         , Wwf         , Wwf         , Wwf         , Wwf         , Gs          , Gg          , 2 Kh        , Gg^Efm      , Gg          , Wwf         , Wwf         , Gg          , Wwf         , Gg          , Wwf         , Wwf         , Ww          , Wwf         , Gg^Fet      , Gg          , Xu          , Chs         , Chs         , Chs         , Chs         , Chs         , Xu          , Xu          
Xu          , Gg          , Ch          , Gg          , Gs          , Gs          , Xu          , Xu          , Ss          , Wwf         , Wwf         , Wwf         , Gg          , Gg          , Gs^Fp       , Gg          , Wwf         , Gg^Efm      , Gg          , 1 Kh        , Rr          , 3 Kh        , Gg          , Gs          , Wwf         , Wwf         , Ww          , Wwf         , Chw         , Ww          , Wwf         , Wwf         , Gg          , Mm          , Xu          , Chs         , Chs         , Chs         , Chs         , Chs         , Xu          , Xu          
Xu          , Gg          , Gg          , Gg          , Xu          , Xu          , Gs^Fp       , Hh          , Gg          , Gg          , Gg          , Gg          , Hh          , Gg          , Gg          , Gg          , Gg          , Wwf         , Wwf         , Gg^Wm       , 5 Kh        , 4 Kh        , Gg^Efm      , Gs          , Wwf         , Wwf         , Wwf         , Wwf         , Wwf         , Wwf         , Gs^Ft       , Ss          , Xu          , Xu          , Xu          , Gg          , Chs         , Chs         , Chs         , Hh          , Xu          , Xu          
Xu          , Dd          , Hd          , Dd          , Xu          , Hh          , Gs^Fp       , Gg          , Hh          , Gg          , Gs^Fp       , Gg          , Ch          , Hh          , Hh          , Gg          , Gs^Fp       , Gg          , Wwf         , Gs          , Gg          , Gg          , Wwf         , Wwf         , Gg          , Gg          , Gg^Efm      , Gg          , Gg          , Gg          , Xu          , Xu          , Xu          , Ss          , Xu          , Gs^Fp       , Ss          , Gg          , Wwf         , Gg          , Xu          , Xu          
Xu          , Dd          , Gg          , Dd          , Xu          , Gg          , Gg^Efm      , Gg          , Gg          , Gg          , Gg          , Gs^Fp       , Xu          , Xu          , Xu          , Xu          , Xu          , Ss          , Gg          , Wwf         , Wwf         , Wwf         , Gs^Fp       , Wwf         , Xu          , Xu          , Xu          , Xu          , Xu          , Xu          , Gg^Fet      , Mm          , Xu          , Xu          , Wwf         , Ss          , Wwf         , Wwf         , Ww          , Wwf         , Xu          , Xu          
Xu          , Gg          , Cud         , Gg          , Xu          , Gg          , Gs^Fp       , Ch          , Gs          , Gs          , Xu          , Xu          , Gs          , Gs^Fp       , Gg          , Hh          , Xu          , Gs^Fp       , Gs          , Gg          , Wwf         , Gs^Fp       , Wwf         , Wwf         , Xu          , Ss          , Ss          , Ss          , Xu          , Mm          , Xu          , Xu          , Ww          , Wwf         , Ss          , Wwf         , Ss          , Ss          , Ss          , Gg          , Xu          , Xu          
Xu          , Gg          , Gg          , Gg          , Xu          , Gs^Fp       , Gg          , Gs^Fp       , Gs          , Gg          , Xu          , Hh          , Gg^Efm      , Gg          , Gs          , Gg^Efm      , Hh          , Xu          , Gs^Fp       , Gg          , Gg          , Wwf         , Hh          , Xu          , Wwf         , Wwf         , Ss          , Ss          , Xu          , Xu          , Ww          , Ss          , Ss          , Ss          , Hh          , Gg          , Ss          , Ss          , Ww          , Gs^Fp       , Xu          , Xu          
Xu          , Aa          , Ha          , Aa          , Xu          , Hh          , Gg          , Gg          , Gg          , Hh          , Xu          , Gg          , Gs^Fp       , Gg          , Gg          , Gs          , Ss          , Xu          , Gs^Fp       , Hh          , Gg          , Wwf         , Ch          , Xu          , Ss          , Gg          , Gg          , Gs^Ft       , Gg          , Gg          , Ww          , Ss          , Ss          , Gg          , Ss          , Gg          , Ww          , Ss          , Xu          , Xu          , Xu          , Xu          
Xu          , Aa          , Gg          , Aa          , Xu          , Ch          , Gg          , Gs          , Gg          , Gs^Fp       , Xu          , Gs^Fp       , Gs          , Gs          , Gg          , Gs^Fp       , Gs^Fp       , Xu          , Gg          , Gg          , Gs          , Wwf         , Wwf         , Xu          , Ss          , Wwf         , Gg          , Wwf         , Gg          , Hh          , Mm          , Wwf         , Wwf         , Gs^Fp       , Ss          , Wwf         , Xu          , Xu          , Ss          , Ss          , Xu          , Xu          
Xu          , Gg          , Cud         , Gg          , Xu          , Gg          , Gg          , Hh          , Gg          , Gg          , Xu          , Gs          , Hh          , Hh          , Gg          , Gg^Efm      , Gg          , Xu          , Ch          , Gs^Fp       , Gs          , Gg          , Ss          , Xu          , Xu          , Hh          , Ss          , Ss          , Gs^Ft       , Gg          , Gs^Ft       , Ss          , Ss          , Ww          , Xu          , Xu          , Xu          , Ss          , Xu          , Xu          , Xu          , Xu          
Xu          , Gg          , Gg          , Gg          , Xu          , Gs^Fp       , Gs          , Gs          , Gs^Fp       , Ch          , Gg          , Xu          , Xu          , Gg          , Gg          , Hh          , Gs          , Xu          , Gg          , Hh          , Gs          , Gs^Fp       , Gg          , Xu          , Gg^Efm      , Xu          , Ss          , Ss          , Ss          , Gg          , Gg          , Ss          , Ss          , Xu          , Xu          , Ss          , Ss          , Xu          , Xu          , Xu          , Xu          , Xu          
Xu          , Uu          , Uh          , Uu          , Xu          , Ss          , Hh          , Gg          , Gg          , Gg          , Gg          , Gs^Fp       , Gg          , Xu          , Xu          , Gs^Fp       , Gs^Fp       , Xu          , Gg          , Gg          , Gs^Fp       , Gg          , Hh          , Xu          , Gg          , Xu          , Wwf         , Ss          , Gs          , Gg          , Ss          , Gg          , Ss          , Gs^Ft       , Gs          , Xu          , Xu          , Xu          , Xu          , Xu          , Xu          , Xu          
Xu          , Uu          , Gg          , Uu          , Xu          , Gg          , Gg          , Gg          , Hh          , Gs          , Gs          , Gs          , Gs          , Gg          , Gg          , Xu          , Xu          , Xu          , Hh          , Gg          , Gg          , Gg^Efm      , Gg          , Xu          , Xu          , Xu          , Ss          , Gg          , Gs^Ft       , Gg          , Gg          , Gg          , Hh          , Wwf         , Wwf         , Gg          , Mm          , Xu          , Xu          , Xu          , Xu          , Xu          
Xu          , Gg          , Chw         , Gg          , Xu          , Gs^Fp       , Gs^Fp       , Gg          , Gg          , Gg          , Gg          , Gs^Fp       , Gs          , Hh          , Gg          , Gs^Fp       , Gg          , Xu          , Gs^Fp       , Gg          , Hh          , Gg          , Ch          , Xu          , Ch          , Xu          , Wwf         , Gg          , Gg          , Ss          , Ss          , Wwf         , Gg          , Wwf         , Ss          , Gs^Ft       , Hh          , Xu          , Xu          , Xu          , Xu          , Xu          
Xu          , Gg          , Gg          , Gg          , Xu          , Gs          , Gg          , Gg          , Gg^Efm      , Ch          , Gs          , Gs^Fp       , Ch          , Gg          , Hh          , Gg          , Gs^Fp       , Ss          , Gg          , Gg          , Gg          , Gg          , Gs          , Xu          , Xu          , Xu          , Gs^Fp       , Ss          , Ss          , Ss          , Xu          , Wwf         , Gg          , Ss          , Ss          , Ss          , Gs^Ft       , Wwf         , Xu          , Ss          , Xu          , Xu          
Xu          , Ww          , Wo          , Ww          , Xu          , Gg          , Ch          , Gg          , Xu          , Xu          , Xu          , Gs^Fp       , Gs^Fp       , Gg          , Ss          , Gs          , Hh          , Gg          , Gg          , Ch          , Gs          , Gs^Fp       , Ss          , Xu          , Ch          , Xu          , Ss          , Gg          , Hh          , Hh          , Xu          , Ss          , Gs          , Gg          , Gs^Ft       , Ss          , Ss          , Wwf         , Hh          , Xu          , Xu          , Xu          
Xu          , Ww          , Gg          , Ww          , Xu          , Gg          , Gg          , Gg          , Gg          , Hh          , Hh          , Xu          , Xu          , Xu          , Xu          , Gg          , Gg          , Gs          , Gs          , Gs^Fp       , Gs^Fp       , Gs          , Xu          , Xu          , Xu          , Xu          , Ss          , Gg          , Gg          , Ss          , Xu          , Ss          , Gs          , Gg          , Hh          , Ss          , Gs          , Wwf         , Ss          , Ss          , Mm          , Xu          
Xu          , Gg          , Ch          , Gg          , Xu          , Gs^Fp       , Gg          , Hh          , Gg          , Gs^Fp       , Gs^Fp       , Ss          , Gg          , Hh          , Gg          , Gg          , Ch          , Gg          , Gg          , Gs^Fp       , Xu          , Xu          , Xu          , Ch          , Xu          , Gs^Fp       , Gg          , Ss          , Wwf         , Wwf         , Xu          , Xu          , Gs^Ft       , Gg          , Gg          , Gs          , Ss          , Gs          , Ss          , Hh          , Gg          , Xu          
Xu          , Gg          , Gg          , Gg          , Xu          , Hh          , Gg          , Gs^Fp       , Gg          , Gg          , Gg          , Mm          , Gg          , Gs^Fp       , Gg          , Gg          , Gg          , Gg          , Xu          , Xu          , Xu          , Ch          , Xu          , Xu          , Chs         , Gg          , Ss          , Wwf         , Gs^Fp       , Gs^Fp       , Xu          , Xu          , Ss          , Ss          , Ss          , Gg          , Gg          , Gg          , Chs         , Gg          , Chs         , Xu          
Xu          , Mm          , Mm^Xm       , Mm          , Xu          , Xu          , Xu          , Gg          , Ch          , Ch          , Ch          , Gg          , Gg^Efm      , Gg          , Gs^Fp       , Gg          , Gg          , Gg^Efm      , Xu          , Ch          , Xu          , Xu          , Chs         , Chs         , Chs         , Chs         , Chs         , Gg          , Xu          , Xu          , Xu          , Xu          , Mm          , Ss          , Hh          , Ss          , Wwf         , Chs         , Chs         , Chs         , Chs         , Xu          
Xu          , Mm          , Gg          , Mm          , Xu          , Xu          , Xu          , Ch          , Ch          , Ch          , Ch          , Ch          , Gg          , Gg          , Gg          , Hh          , Gs^Fp       , Xu          , Ch          , Xu          , Xu          , Xu          , Chs         , Chs         , Chs         , Chs         , Chs         , Xu          , Ss          , Ss          , Xu          , Xu          , Xu          , Ss          , Wwf         , Wwf         , Chs         , Chs         , Chs         , Chs         , Chs         , Xu          
Xu          , Gg          , Cud         , Gg          , Xu          , Xu          , Xu          , Ch          , Ch          , 7 Kh        , Ch          , Ch          , Xu          , Hh          , Gg          , Ss          , Xu          , Xu          , Ch          , Xu          , Xu          , Xu          , Khs         , Chs         , Chs         , Chs         , Chs         , Xu          , Xu          , Xu          , Xu          , Xu          , Xu          , Xu          , Mm          , Gg          , Chs         , Chs         , Chs         , Chs         , 9 Khs       , Xu          
Xu          , Xu          , Xu          , Xu          , Xu          , Xu          , Xu          , Xu          , Xu          , Xu          , Xu          , Xu          , Xu          , Xu          , Xu          , Xu          , Xu          , Xu          , Xu          , Xu          , Xu          , Xu          , Xu          , Xu          , Xu          , Xu          , Xu          , Xu          , Xu          , Xu          , Xu          , Xu          , Xu          , Xu          , Xu          , Xu          , Xu          , Xu          , Xu          , Xu          , Xu          , Xu          
